sevenfold	septemplex
din	crepitus
attempt	conatus
languid	languidus
quarrel	lis
lawsuit	lis
cover	contego
status	condicio
situation	condicio
agreement	condicio
numbness	torpor
incurable	immedicabilis
megaera	megaera
majesty	maiestas
greatness	maiestas
loosen	discludo
open	discludo
trivial	ludicer
vain	ludicer
threaten	minitor
demand	efflagito
echo	responso
umbrian	umber
glitter	resplendeo
incline	vergo
command	imperito
taburnus	taburnus
sila	sila
apennines	appenninus
indicate	significo
saces	saces
attack	incesso
happen	accido
fall	accido
waxen	cereus
lyrnesus	lyrnesus
cupencus	cupencus
hyllus	hyllus
murranus	murranus
ransack	populor
ravage	populor
rent	conduco
hire	conduco
peridia	peridia
theban	echionius
echionian	echionius
onites	onites
cethegus	cethegus
tanais	tanais
talos	talos
sucro	sucro
rapid	incitus
food	esca
swallow	hirundo
wagon	temo
metiscus	metiscus
heroine	virago
epulo	epulo
arcetius	arcetius
osiris	osiris
kiss	delibo
sip	delibo
juice	sucus
ambrosia	ambrosia
healthy	salubris
stalk	caulis
pubescent	pubes
youthful	pubes
dittany	dictamnus
aid	subvenio
medical	medicus
healing	medicus
touch	degusto
lance	lancea
edonic	edonus
plunging	sternax
sybaris	sybaris
asbytes	asbytes
measure	metior
affect	afficio
spy	speculator
courier	speculator
dolon	dolon
eumedes	eumedes
imbrasus	imbrasus
lades	lades
thamyrus	thamyrus
wretchedly	miserabile
thrace	thraca
sudden	repens
overhang	superimmineo
alsus	alsus
podalirius	podalirius
vapor	nidor
ebusus	ebusus
victim	victima
rein	infreno
bold	animosus
courageous	animosus
gylippus	gylippus
hissing	stridulus
conceal	obscuro
beautiful	excellens
surpassing	excellens
reduce	recido
consecrate	sancio
shrine	sacrarium
token	specimen
pour	profundo
juturna	iuturna
rest	reclino
recline	reclino
laurel	verbena
measure	dimetior
exalted	elatus
high	elatus
myrrh	murra
summons	vocatus
calling	vocatus
brass	orichalcum
surpass	anteeo
orithyia	orithyia
idmon	idmon
rose	rosa
redness	rubor
tilt	inclino
bend	inclino
influence	inclino
heal	medeor
disprove	refuto
repel	refuto
receive	adscio
ally	adscio
white	albeo
composed	sedatus
renegade	desertor
grow	glisco
robber	latro
unappeasable	implacabilis
dash	arieto
stumble	arieto
strike	arieto
galloping	quadrupedus
atinas	atinas
dercennus	dercennus
maltreat	mulco
beat	mulco
acca	acca
hide	remulceo
fondle	remulceo
breast	papilla
nipple	papilla
cretan	gortynius
gortynian	gortynius
foreign	peregrinus
chloreus	chloreus
wherever	quacumque
arruns	arruns
maeonidae	maeonidae
example	exemplum
sample	exemplum
sinuous	sinuosus
eagle	aquila
opposed	adversus
against	adversus
opposite	adversus
facing	adversus
disembowel	eviscero
hawk	accipiter
aunus	aunus
appenninicola	appenninicola
redouble	congemino
mock	eludo
disprove	redarguo
feminine	muliebris
female	muliebris
adjectively	pugnator
fighter	pugnator
huntsman	venator
ornytus	ornytus
chromis	chromis
demophoon	demophoon
harpalycus	harpalycus
tereus	tereus
hippotades	hippotades
amastrus	amastrus
pagasus	pagasus
liris	liris
euneus	euneus
hippolyte	hippolyte
thermodon	thermodon
attendant	ministra
servant	ministra
tarpeia	tarpeia
tulla	tulla
larina	larina
unwearied	indefessus
amazon	amazon
herminius	herminius
iollas	iollas
leg	crus
shin	crus
impatient	impatiens
orsilochus	orsilochus
overcast	superiacio
aconteus	aconteus
tyrrhenus	tyrrhenus
cover	obtexo
reach	iactus
shot	iactus
leap	iactus
cast	iactus
precisely	numero
upon	inspoliatus
virginity	virginitas
swan	olor
lip	labrum
fierceness	feritas
book	liber
full	abundans
overflowing	abundans
casmilla	casmilla
metabus	metabus
privernum	privernum
delight	dulcedo
sweetness	dulcedo
latonia	latonia
opis	opis
recantation	receptus
retraction	receptus
fit	accommodus
hollow	convexus
scout	explorator
luxuriant	luxurio
mare	equa
protector	praeses
perfume	vaporo
fumigate	vaporo
matron	matrona
company	manipulus
volusus	volusus
chirping	loquax
talkative	loquax
padusa	padusa
disagreement	dissensus
blessing	bonum
good	bonum
tolumnius	tolumnius
bite	mordeo
embitter	acerbo
aufidus	aufidus
adriatic	hadriacus
deservedly	merito
eloquence	eloquium
unlamented	infletus
cheap	vilis
inviolable	inviolabilis
violence	violentia
mutter	musso
fame	nobilitas
weak	futilis
vain	futilis
chair	sella
seat	sella
material	materies
ally	adscisco
adopt	adscisco
troublesome	importunus
resemble	assideo
roaring	fremor
beware	caveo
greece	graecia
grasp	appeto
tearful	lacrimosus
dreadful	horribilis
mycenaean	mycenaeus
proteus	proteus
caphereus	caphareus
garganus	garganus
argyripa	argyripa
outlay	impensa
darken	obumbro
overshadow	obumbro
aggravate	ingravo
bereft	orbus
opulent	praedives
wealthy	praedives
bury	infodio
invert	inverto
slay	iugulo
untimely	immaturus
surviving	superstes
beginning	rudimentum
prudent	cautus
careful	cautus
cautious	cautus
beat	plango
separate	discrimino
foreboding	praenuntius
cart	plaustrum
sequestrpace	sequester
drances	drances
limit	finio
finish	finio
refuse	aspernor
repel	aspernor
slight	aspernor
aethon	aethon
hyacinth	hyacinthus
violet	viola
thumb	pollex
reap	demeto
couch	stramen
shade	inumbro
overshadow	inumbro
covering	obtentus
oaken	quernus
present	intersum
between	intersum
protection	praesidium
shameful	pudendus
equally	aeque
acoetes	acoetes
anticipate	praesumo
ride	equito
horseman	equito
hairy	hirsutus
rough	hirsutus
accustom	consuesco
rhaebus	rhaebus
disfigure	deformo
hair	capillus
soil	turpo
uplift	sublevo
genius	indoles
weave	neo
spin	neo
ploughman	arator
impede	inligo
famed	memorandus
recall	reminiscor
antores	antores
vow	voveo
undaunted	imperterritus
nealces	nealces
thronius	thronius
valerus	valerus
agis	agis
ericetes	ericetes
orses	orses
rapo	rapo
parthenius	parthenius
hydaspes	hydaspes
sacrator	sacrator
alcathous	alcathous
orodes	orodes
acron	acron
rage	infremo
bellow	infremo
reedy	harundineus
vesulus	vesulus
theano	theano
mimas	mimas
euanthes	euanthes
palmus	palmus
latagus	latagus
dolichaon	dolichaon
disgrace	dedecus
shame	dedecus
loftily	sublime
osinius	osinius
mound	crepido
base	crepido
counterfeit	adsimulo
words	orsa
weeping	adlacrimans
immediate	instans
present	instans
daunus	daunus
leap	salio
fury	fervor
lucagus	lucagus
niphaeus	niphaeus
aegaean	aegaeon
amyclae	amyclae
ausonides	ausonides
lucas	lucas
antaeus	antaeus
fish	piscis
there	istic
dryope	dryope
tarquitus	tarquitus
perhaps	fortasse
anxur	anxur
haemonides	haemonides
negotiation	commercium
trade	commercium
quivering	tremebundus
cunning	astus
magus	magus
immolate	immolo
eurytides	eurytides
clonus	clonus
bestow	largior
piercing	penetrabilis
irrecoverable	inreparabilis
near	contiguus
savage	trux
beholder	spectator
undestroyed	imperditus
destroy	interimo
terrify	perterreo
unarmed	inermus
imaon	imaon
hurled	missilis
strymonius	strymonius
demodocus	demodocus
pheres	pheres
ladon	ladon
tyres	tyres
teuthras	teuthras
intercept	intercipio
rhoeteus	rhoeteus
cut	decido
evandrian	evandrius
unseparated	indiscretus
thymber	thymber
larides	larides
anchemolus	anchemolus
sthenius	sthenius
comrade	sodalis
hisbo	hisbo
recover	recepto
lagus	lagus
nature	natura
unmounted	pedester
pedestrian	pedester
overthrow	diruo
thicket	arbustum
grove	arbustum
ismar	ismara
dryops	dryops
strict	rigidus
rigid	rigidus
hard	rigidus
graze	perstringo
thigh	femur
direction	tenor
course	tenor
maeon	maeon
partly	partim
cydon	cydon
down	lanugo
pharon	pharon
melampus	melampus
club	clava
lichas	lichas
sew	suo
theron	theron
kill	occido
retreat	relabor
support	sustento
strike	infligo
unhindered	inoffensus
resound	remurmuro
faint	langueo
trust	concredo
break	perfringo
sirian	sirius
mournfully	lugubre
comet	cometes
crane	grus
strymonian	strymonius
repair	reficio
paddle	subremigo
cybele	cybele
phoebe	phoebe
nightly	noctivagus
help	subsidium
murmur	murmuro
hairy	hispidus
shaggy	hispidus
aulestes	aulestes
mincius	mincius
benacus	benacus
mantu	mantua
manto	manto
ocnus	ocnus
cycnus	cycnus
cupavo	cupavo
cinyrus	cinyrus
ligurian	ligus
graviscae	graviscae
pyrgi	pyrgi
minio	minio
astur	astur
pisae	pisae
alphean	alpheus
prophetic	praesagus
unexhausted	inexhaustus
ilv	ilva
populonia	populonia
quiver	gorytus
cosa	cosa
clusium	clusium
pactolus	pactolus
eminent	generosus
noble	generosus
ismarus	ismarus
decent	honestus
honorable	honestus
mnestheus	menestheus
acmon	acmon
lyrnesian	lyrnesius
thaemon	thaemon
clarus	clarus
thymbris	thymbris
castor	castor
imbrasides	imbrasides
asius	asius
enterprise	exorsum
quarrel	iurgium
altercation	iurgium
adulterer	adulter
perishing	fluxus
draw	obtendo
bride	pacta
venilia	venilia
amathus	amathus
truly	sane
certainly	sane
untried	intentatus
fault	peccatum
arpi	arpi
aetolian	aetolus
overflow	inundo
prohibition	vetitum
breathe	respiro
jingling	tinnitus
unhastened	improperatus
cretheus	cretheus
clytius	clytius
ravager	vastator
sword	gladius
lynceus	lynceus
prytanis	prytanis
noemon	noemon
halius	halius
alcander	alcander
halys	halys
obtrude	ingero
carry	ingero
gyges	gyges
hamstring	poples
phaleris	phaleris
uncultivated	rudis
exclude	excludo
warrior	bellator
inarime	inarime
prochyt	prochyta
mole	pila
pier	pila
baiae	baiae
faithful	fidelis
loudly	magnum
largely	magnum
aphidnus	aphidnus
erymas	erymas
merops	merops
lungs	pulmo
lung	pulmo
chest	stomachus
theban	thebanus
antiphates	antiphates
incite	concieo
supply	praebeo
haemon	haemon
tmarus	tmarus
aquicolus	aquicolus
quercens	quercens
athesis	athesis
iaera	iaera
alcanor	alcanor
penalty	multa
striking	flictus
justly	iure
rightly	iure
honored	mactus
drum	tympanum
dindyma	dindyma
chaplet	redimiculum
inactivity	desidia
idleness	desidia
saffron	crocum
weaken	debilito
awake	invigilo
numanus	numanus
split	diffindo
sling	funda
palici	palici
needle	acus
hairpin	acus
arcens	arcens
themillas	themillas
privernus	privernus
idas	idas
promolus	promolus
dioxippus	dioxippus
clonius	clonius
itys	itys
ortygius	ortygius
asilas	asilas
liger	liger
emathion	emathion
lucetius	lucetius
fracture	fragmen
pleasantness	lepor
licymnia	licymnia
helenor	helenor
consume	adedo
capture	expugno
assault	expugno
calliope	calliope
projectile	missile
missile	missile
open	interluceo
actor	actor
numb	torpeo
hastening	festinus
announcing	nuntius
winged	pennatus
numa	numa
stab	confodio
push	proturbo
vexed	gravor
burdened	gravor
rain	pluvia
cut	succido
tagus	tagus
gasp	singultus
sulmo	sulmo
cupola	tholus
hyrtacus	hyrtacus
latonian	latonius
parting	divortium
separation	divortium
lurid	sublustris
volcens	volcens
caedicus	caedicus
distant	absens
absent	absens
remulus	remulus
boss	bulla
amulet	bulla
locket	bulla
bubble	bulla
complete	perfectus
excessive	nimius
abaris	abaris
rhoetus	rhoetus
herbesus	herbesus
fadus	fadus
rave	perfuro
mute	mutus
inarticulate	mutus
insane	vesanus
unfed	impastus
lamus	lamus
lamyrus	lamyrus
sob	singulto
rashly	temere
blow	proflo
rhamnes	rhamnes
foremost	primoris
first	primoris
exchange	permuto
lycaon	lycaon
weep	inlacrimo
dissimilar	dissimilis
sixth	sex
six	sex
red	rubeo
arisba	arisba
immediately	actutum
promptly	actutum
destroy	deleo
immediately	confestim
pursue	persequor
buy	emo
train	erudio
instruct	erudio
opheltes	opheltes
summon	accio
unshorn	intonsus
unshaven	intonsus
diversify	vario
vary	vario
refresh	procuro
injure	pecco
fertile	fertilis
productive	fertilis
before	prae
plunge	demergo
dip	demergo
pitch	pix
galatea	galatea
doto	doto
nereian	nereius
heavens	mundus
universe	mundus
world	mundus
disquieted	anxius
troubled	anxius
shape	formo
form	formo
protection	praesentia
presence	praesentia
fortification	vallum
fired	ignesco
bleating	balatus
endure	perpetior
sheepcote	ovile
ambush	insidior
ganges	ganges
soothe	sedo
etruscan	lydus
lydian	lydus
thaumantias	thaumantias
pilumnus	pilumnus
araxes	araxes
dahae	dahae
rhine	rhenus
euphrates	euphrates
carian	car
leleges	leleges
african	afer
mulciber	mulciber
ungird	discingo
examine	recognosco
iapyx	iapyx
arab	arabs
anubis	anubis
barker	latrator
egyptian	aegyptius
bactra	bactra
egypt	aegyptos
red	ruber
antonius	antonius
beaked	rostratus
agrippa	agrippa
overhanging	minax
projecting	minax
catilina	catilina
chariot	pilentum
luperci	luperci
milky	lacteus
goose	anser
stalk	culmus
manlius	manlius
cloelia	cloelia
cocles	cocles
bridge	pons
porsenn	porsenna
thorn	vepres
mettus	mettus
sow	porca
pig	porca
tatius	tatius
romans	romulidae
texture	textum
fatal	fatifer
separate	secerno
tepid	egelidus
lukewarm	egelidus
silvanus	silvanus
caere	caere
hoof	ungula
fetid	putris
dusty	pulvereus
cavalry	equitatus
wound	vulnero
deprive	viduo
erulus	erulus
unsatisfied	inexpletus
double	duplico
yesterdays	hesternus
surely	profecto
gleam	rutilo
redden	rutilo
dry	sudus
unexpectedly	improviso
frost	gelu
tarcho	tarcho
fasten	subiungo
maeonia	maeonia
diviner	haruspex
present	praesum
before	praesum
tuscany	etruria
etruria	etruria
surround	circumsisto
kill	neco
torture	tormentum
dead	mortuus
tuscan	etruscus
etrurian	etruscus
etruscan	tuscus
tuscan	tuscus
etrurian	tuscus
saved	sospes
allowed	licitus
panther	panthera
bind	subligo
tunic	tunica
morning	matutinus
lemnius	lemnius
lump	massa
melt	liquesco
steel	chalybs
mistress	magistra
unfinished	imperfectus
smooth	polio
mold	informo
pyracmon	pyracmon
steropes	steropes
brontes	brontes
chalybes	chalybes
allotment	pensum
wool	pensum
endure	tolero
career	curriculum
doubt	indubito
amber	electrum
bind	devincio
born	natus
laurentes	laurentes
carinae	carinae
neat	lautus
washed	lautus
ianiculum	ianiculum
town	oppidum
pastoral	silvestris
capitoline	tarpeius
tarpeian	tarpeius
argiletum	argiletum
lycaean	lycaeus
pan	pan
lupercal	lupercal
carmentis	carmentis
albula	albula
worse	deterior
unteachable	indocilis
founder	conditor
lernaean	lernaeus
nemea	nemea
pholus	pholus
hylaeus	hylaeus
eurystheus	eurystheus
oechali	oechalia
salii	salii
charger	lanx
declining	devexus
cup	scyphus
potitius	potitius
pillage	rapina
plundering	rapina
robbery	rapina
squeeze	ango
smoky	fumifer
millstone	molaris
uncover	detego
impulse	impulsus
convenient	opportunus
suitable	opportunus
abrupt	praecisus
rocky	saxeus
barrier	obex
fortify	emunio
gall	fel
guard	custodio
departure	abitus
young	iuvencus
untried	intractatus
untouched	intractatus
reek	tepeo
cacus	cacus
recess	recessus
superstition	superstitio
expiatory	lustralis
hairy	villosus
shaggy	villosus
interweave	intertexo
pheneos	pheneos
desirous	cupidus
arcadia	arcadia
salamis	salamis
hesione	hesione
proved	spectatus
tested	spectatus
below	infra
fix	pango
fasten	pango
approach	temptamentum
experiment	temptamentum
essay	temptamentum
trial	temptamentum
envoy	legatus
lieutenant	legatus
cyllene	cyllene
atlantis	atlantis
electra	electra
afraid	extimesco
hercules	amphitryoniades
wave	flexus
curl	flexus
oiled	unctus
anointed	unctus
toil	luctamen
striving	luctamen
ripe	mitis
mild	mitis
horned	corniger
detriment	incommodum
pallanteum	pallanteum
euander	evander
pallas	pallas
arcas	arcas
swelling	tumor
carry	reveho
dark	umbrosus
shady	umbrosus
flash	radio
reflect	repercutio
bowl	labrum
venulus	venulus
worshipper	cultor
husbandman	cultor
conspire	coniuro
workbasket	calathus
distaff	colus
camilla	camilla
volscian	volscus
satura	satura
feronia	feronia
sacranus	sacranus
ancestors	veteres
thicken	denseo
argus	argus
argument	argumentum
evidence	argumentum
proof	argumentum
adorn	insignio
io	io
phoebigena	phoebigena
inventor	repertor
discoverer	repertor
paeonius	paeonius
stepmother	noverca
appeasable	placabilis
egeria	egeria
arici	aricia
virbius	virbius
hippolytus	hippolytus
fucinus	fucinus
glassy	vitreus
anguitia	anguitia
marsian	marsus
able	evalesco
umbro	umbro
shot	missus
archippus	archippus
aequian	aequiculus
hunting	venatus
ufens	ufens
nersae	nersae
mountainous	montosus
form	ritus
teutonic	teutonicus
abella	abella
celemna	celemna
batulum	batulum
rufrae	rufrae
sarnus	sarnus
sarrastes	sarrastes
capreae	capreae
teleboae	teleboae
sebethis	sebethis
telon	telon
oebalus	oebalus
unmentioned	indictus
crooked	falcatus
hooked	falcatus
oscan	oscus
saticulus	saticulus
vulturnus	vulturnus
neighbor	accola
shallow	vadosus
cales	cales
halaesus	halaesus
hermus	hermus
allia	allia
nursia	nursia
fabaris	fabaris
himella	himella
casperia	casperia
severus	severus
tetrica	tetrica
mutusc	mutusca
eretum	eretum
tribe	tribus
clausus	clausus
food	pastus
fodder	pastus
pasture	pastus
ciminus	ciminus
soracte	soracte
falisci	falisci
fescennine	fescenninus
messapus	messapus
bluish	liveo
anagnia	anagnia
anio	anio
praeneste	praeneste
legion	legio
caeculus	caeculus
founder	fundator
othrys	othrys
homole	homole
coras	coras
catillus	catillus
tiburtus	tiburtus
untrimmed	impexus
uncombed	impexus
pike	dolo
javelin	pilum
spanish	hiberus
iberian	hiberus
tirynthian	tirynthius
geryon	geryon
laurentian	laurentius
woman	mulier
rhea	rhea
aventinus	aventinus
conqueror	debellator
lausus	lausus
mezentius	mezentius
despiser	contemptor
helicon	helicon
forge	fornax
furnace	fornax
recast	recoquo
plowshare	vomer
greave	ocrea
corselet	thorax
hurdle	crates
antemnae	antemnae
tibur	tibur
atina	atina
whetstone	cos
grease	arvina
clean	tergeo
wipe	tergeo
quiet	inexcitus
dormant	inexcitus
blow	conspiro
open	resero
unbolt	resero
lever	vectis
parthian	parthus
arabian	arabus
arab	arabus
getae	getae
sacrilegious	sacrilegus
will	nutus
nod	nutus
seaweed	alga
overthrow	perverto
overturn	perverto
conjure	obtestor
cave	specus
roaring	fragosus
crashing	fragosus
ampsanctus	ampsanctus
famous	nobilis
illustrious	nobilis
freely	licenter
enough	abunde
sufficiently	abunde
besprinkle	respergo
friendship	amicitia
stain	imbuo
wet	imbuo
permeate	imbuo
drench	imbuo
bleat	balo
fifth	quinque
five	quinque
galaesus	galaesus
almo	almo
cloud	nubilum
darkness	nubilum
palisade	sudes
stake	sudes
trumpet	bucina
venilus	velinus
nar	nar
sulphureous	sulphureus
tremble	contremo
meet	nanciscor
obtain	nanciscor
wildly	immane
burnt	obustus
brand	torris
firebrand	torris
distinguished	eximius
exceptional	eximius
green	virido
comb	pecto
decorate	orno
equip	orno
silvia	silvia
tyrrheus	tyrrheus
nourish	nutrio
encourage	exhortor
abound	exubero
supply	suggero
noise	sonor
flaming	flammeus
fiery	flammeus
hiss	sibilo
openly	palam
dowry	dos
endowment	dos
gift	dos
calybe	calybe
wrinkle	ruga
arde	ardea
danae	danae
dusky	fuscus
dark	fuscus
endure	sustineo
sustain	sustineo
woo	euhoe
lashing	plaga
wound	plaga
blow	plaga
spinning	volubilis
turning	volubilis
craze	lympho
raging	furialis
acrisius	acrisius
inachus	inachus
free	liber
lacedaemon	lacedaemon
robber	praedo
greatly	multa
much	multa
winding	tortilis
twisted	tortilis
touch	attactus
touching	attactus
cook	coquo
amata	amata
gorgonian	gorgoneus
work	opera
sprout	pullulo
plu	pluto
allecto	allecto
deadly	funestus
cisseis	cisseis
bellona	bellona
endow	doto
commodity	merces
wages	merces
pay	merces
unattempted	inausus
calydon	calydon
destroy	perdo
satisfy	exsaturo
phryx	phryx
inachian	inachius
produce	creo
create	creo
illegitimate	nothus
skillful	daedalus
artificial	daedalus
tapestry	tapetum
select	eligo
divine	auguro
wealth	opulentia
unmoved	immobilis
tiara	tiara
turban	tiara
headband	tiara
decay	abolesco
disgraceful	indecor
harmless	innocuus
performance	actus
thronging	effusus
overflowing	effusus
samothracia	samothracia
phrygia	phrygia
auruncan	auruncus
ianus	ianus
sabine	sabinus
italus	italus
court	curia
ancestral	avitus
train	domito
tame	domito
youthful	primaevus
eldest	primaevus
wing	pinna
feather	pinna
ditch	fossa
holy	augustus
speaker	orator
numicus	numicus
invoke	invoco
sport	adludo
wide	patulus
opening	patulus
crust	crustum
want	penuria
fruit	pomum
cake	libum
return	recurro
supported	effultus
conversation	colloquium
poisonous	mephitis
albunea	albunea
prophetic	fatidicus
smoking	fumidus
swarm	examen
multitude	examen
interchangeable	examen
fear    mutuus
terror  mutuus
connect	adiungo
palace	regia
grandfather	atavus
turnus	turnus
marriageable	nubilis
picus	picus
marica	marica
faunus	faunus
position	status
erato	erato
yellowish	luteus
blazing	fervidus
except	praeter
beyond	praeter
past	praeter
bear	ursus
clever	argutus
clear	argutus
cedar	cedrus
daughter	filia
trembling	tremulus
shine	splendeo
direct	rectus
straight	rectus
caieta	caieta
latinus	latinus
spur	calcar
dig	fodio
romulean	romulus
offspring	propago
around	circa
rebellious	rebellis
warring	rebellis
gaul	gallus
marcellus	marcellus
passage	meatus
going	meatus
sweetly	molliter
gently	molliter
softly	molliter
mollius	molliter
restore	restituo
maximus	maximus
fabius	fabius
serranus	serranus
fabricius	fabricius
gracchus	gracchus
cossus	cossus
ca	cato
defile	temero
desecrate	temero
violate	temero
corinth	corinthus
triumph	triumpho
monoecus	monoecus
camillus	camillus
torquatus	torquatus
drusus	drusus
decii	decii
whenever	utcumque
however	utcumque
freedom	libertas
consul	consul
burden	fascis
bundle	fascis
brutus	brutus
tarquinius	tarquinius
public	popularis
ancus	ancus
arrogant	iactans
tullus	tullus
cures	cures
nys	nysa
dionysus	liber
bacchus	liber
quiet	paco
nilus	nilus
sevenfold	septemgeminus
caspian	caspius
indian	indus
saturnus	saturnus
augustus	augustus
berecyntius	berecyntius
heart   cor
bola	bola
fidena	fidena
gabii	gabii
nomentum	nomentum
numitor	numitor
procas	proca
lavinia	lavinia
silvius	silvius
bright	illustris
assembly	conventus
naive	simplex
artless	simplex
bodily	corporeus
utterly	funditus
completely	funditus
earthen	terrenus
hurtful	noxius
guilty	noxius
vigor	vigor
activity	vigor
liveliness	vigor
drink	poto
oblivion	oblivium
murmur	strepo
lily	lilium
countless	innumerus
sequestered	seclusus
moisten	rigo
reckon	recenseo
dwell	incolo
inhabit	incolo
meadow	pratum
musaeus	musaeus
refine	excolo
eridanus	eridanus
scallop	pecten
comb	pecten
clothe	vestio
brothel	fornix
vault	fornix
phlegyas	phlegyas
draw	distringo
adultery	adulterium
wealth	divitia
riches	divitia
dependent	cliens
client	cliens
rise	exsurgo
royal	regificus
magnificent	regificus
support	fulcrum
genial	genialis
like	adsimilis
ixion	ixion
lapitha	lapitha
reproduced	renascor
fiber	fibra
immortal	immortalis
hooked	obuncus
vulture	vultur
tityos	tityos
smoky	fumeus
tramp	pulsus
imitate	imitor
salmoneus	salmoneus
cancel	rescindo
titanian	titanius
snake	hydra
prisoner	custodia
protection	custodia
custody	custodia
guilty	sons
hurtful	sons
differ	differo
divulge	differo
scatter	differo
rhadamanthus	rhadamanthus
fetter	catena
chain	catena
sleepless	exsomnis
tisiphone	tisiphone
elysian	elysius
slaughter	strages
nostril	naris
ignominious	inhonestus
dishonorable	inhonestus
barbarously	crudeliter
cruelly	crudeliter
lacerate	lanio
yawn	hio
frustrate	frustror
move	confero
transfer	confero
collect	confero
idaeus	idaeus
polyboetes	polyboetes
antenorides	antenorides
thersilochus	thersilochus
medon	medon
doomed	caducus
adrastus	adrastus
parthenopaeus	parthenopaeus
tydeus	tydeus
former	pristinus
shady	umbrifer
departure	discessus
able	queo
rugged	sentus
thorny	sentus
shape	figura
form	figura
caeneus	caeneus
laodamia	laodamia
evadne	evadne
eriphyl	eriphyla
procris	procris
phaedra	phaedra
consume	peredo
melting	tabes
control	coerceo
enclose	coerceo
unlovely	inamabilis
poverty	pauperies
hate	perodi
minos	minos
investigation	quaesitor
juror	iudex
judge	iudex
wailing	vagitus
throat	guttur
windpipe	guttur
mouthful	offa
dye	medico
medicate	medico
treat	medico
cerberus	cerberus
abandon	expono
dark	glaucus
slime	limus
mud	limus
leaky	rimosus
cavity	alveus
venerable	venerabilis
uncle	patruus
bark	latro
eternally	aeternum
continually	aeternum
amphrysius	amphrysius
attempt	adorior
attack	adorior
pirithous	pirithous
convey	vecto
drowsy	soporus
rattle	increpo
serious	severus
mother	creatrix
velian	velinus
unconquered	invictus
agreeable	iucundus
delightful	iucundus
pleasant	iucundus
savage	violentus
violent	violentus
deceive	deludo
stormy	ventosus
windy	ventosus
leucaspis	leucaspis
admit	admitto
envious	lividus
bluish	lividus
remove	summoveo
fall	autumnus
rowboat	cumba
sordid	sordidus
dirty	sordidus
hoariness	canities
charon	charon
foulness	squalor
ferryman	portitor
carrier	portitor
fret	aestuo
seethe	aestuo
burn	aestuo
chasm	vorago
dirt	caenum
tartarean	tartareus
skilled	doctus
learned	doctus
taught	doctus
fearfully	horrendum
lerna	lerna
beast	belua
briareus	briareus
hundredfold	centumgeminus
stay	stabulo
viperous	vipereus
dissention	discordia
disagreement	discordia
deadly	mortifer
want	egestas
need	egestas
poverty	egestas
desperate	malesuadus
disease	morbus
sickness	morbus
dip	mergo
phlegethon	phlegethon
timid	timidus
cowardly	timidus
hesitant	timidus
need	opus
profane	profanus
begin	incoho
knife	culter
plowshare	culter
sacrifice	libamen
libation	libamen
bristle	saeta
bird	volans
throat	hiatus
gaping	hiatus
quick	properus
corynaeus	corynaeus
absorbent	bibulus
oil	olivum
burn	cremo
ministry	ministerium
service	ministerium
bier	feretrum
hot	calidus
warm	calidus
adorn	decoro
plant	semino
green	vireo
wintry	brumalis
perch	sido
aromatic	olens
go	prodeo
shade	opaco
truly	vere
smite	ico
foaming	spumosus
shellfish	concha
lower	inferior
inhume	humo
interweave	sero
result	eventus
styx	styx
decision	consultum
decree	consultum
defile	incesto
trace	vestigo
track	vestigo
metal	metallum
mine	metallum
crop	decerpo
partitive	opertum
valley	convallis
surround	circumvenio
cocytus	cocytus
descent	descensus
theseus	theseus
purchase	redimo
pollux	pollux
harmonious	canorus
orpheus	orpheus
marsh	palus
advise	praecipio
anticipate	praecipio
spur	stimulus
prick	stimulus
resound	remugio
venturing	audens
complete	defungor
finish	defungor
raging	rabidus
mad	rabidus
savage	rabidus
raving	rabidus
mockery	ludibrium
mocking	ludibrium
educate	instituo
equip	instituo
undertake	instituo
prescient	praescius
foreknowing	praescius
survey	obeo
visit	obeo
adorn	como
arrange	como
flock	grex
herd	grex
spectacle	spectaculum
deiphobe	deiphobe
icarus	icarus
string	filum
thread	filum
in	insum
minotaurus	minotaurus
pasiphae	pasiphae
substitute	suppo
put	suppo
urn	urna
weigh	pendo
chalcidian	chalcidicus
arctos	arctos
unaccustomed	insuetus
daedalus	daedalus
trivia	trivia
secret	secretum
seed	semen
cumae	cumae
euboean	euboicus
float	fluito
sirenes	sirenes
unexpected	inopinus
drug	soporo
dew	ros
lethean	lethaeus
oblivious	lethaeus
false	fallax
treacherous	fallax
deceitful	fallax
ignore	ignoro
steal	furor
iasides	iasides
word	loquela
speech	loquela
talking	loquela
phorbas	phorbas
dream	somnium
murky	tenebrosus
dark	tenebrosus
left	sinister
cymodoce	cymodoce
thalia	thalia
spio	spio
nisaee	nisaee
melite	melite
thetis	thetis
palaemon	palaemon
glaucus	glaucus
thundering	tonans
calm	permulceo
stroke	permulceo
avernus	avernus
drive	impingo
tamer	domitor
laurentine	laurens
foully	foede
shamefully	foede
witness	testis
annihilate	perimo
break	infringo
soothe	mitigo
kindred	consanguineus
endurable	tolerabilis
idalian	idalius
forum	forum
plough	aratrum
arrange	designo
vigorous	vividus
lively	vividus
boat	navigium
enroll	transcribo
communicate	edoceo
summon	arcesso
fetch	arcesso
lar	lar
gasping	anhelus
panting	anhelus
elysium	elysium
charming	amoenus
conflict	congressus
subdue	debello
gathered	lectus
expel	depello
acesta	acesta
nautes	nautes
drip	madesco
height	arduum
emit	edo
hostile	exosus
useful	prosum
heat	vapor
steam	vapor
vapor	vapor
belch	vomo
vomit	vomo
tow	stuppa
hasten	accelero
eumelus	eumelus
wedge	cuneus
grudging	malignus
malicious	malignus
wicked	malignus
malignant	malignus
pyrgo	pyrgo
age	natus
birth	natus
amaze	stupefacio
shake	corusco
unfortunate	infaustus
doryclus	doryclus
beroe	beroe
harm	noceo
pass	trames
crossway	trames
glut	saturo
fill	saturo
time	porro
forward	porro
ancient	priscus
hinder	impedio
retreat	recursus
return	recursus
bright	candidus
clear	candidus
atys	atys
increase	augeo
chain	circulus
ring	circulus
pliant	flexilis
flexible	flexilis
shine	luceo
troop	turma
boyish	puerilis
epytides	epytides
prefer	praefero
call	appello
cisseus	cisseus
thracian	thracius
lot	exsors
fall	decido
applaud	plaudo
approve	plaudo
clap	plaudo
strike	plaudo
flaxen	lineus
string	nervus
cord	nervus
tendon	nervus
muscle	nervus
bend	incurvo
pandarus	pandarus
eurytion	eurytion
hippocoon	hippocoon
hyrtacides	hyrtacides
mast	malus
crush	effringo
balance	libro
vomit	eiecto
coarse	crassus
crass	crassus
fat	crassus
thick	crassus
separate	dirimo
madness	dementia
erymanthus	erymanthus
foresee	praevideo
fort	castellum
castle	castellum
attack	oppugno
strong	valens
provoke	lacesso
unfrightened	interritus
finger	digitus
taint	inficio
hercules	hercules
anchisiades	anchisiades
lead	plumbum
youthfulness	iuventas
exhausted	effetus
cold	frigeo
blunt	hebeo
loiter	tardo
hardy	patiens
patient	patiens
green	viridans
entellus	entellus
lively	alacer
extend	protendo
stretch	extendo
strike	percello
bebrycian	bebrycius
butes	butes
dares	dares
comfort	solacium
announce	propono
propose	propono
unfasten	refigo
didymaon	didymaon
damp	udus
wet	udus
burdensome	onerosus
declare	proclamo
support	adiuvo
assist	adiuvo
help	adiuvo
goodwill	favor
dung	fimus
mire	fimus
waver	titubo
shoe	calx
satisfied	contentus
content	contentus
polished	teres
tapering	teres
belt	balteus
fill	circumamplector
encircle	circumamplector
amazonian	amazonius
ornaments	phalerae
olive	oliva
arrow	spiculum
sting	spiculum
customary	adsuetus
usual	adsuetus
panopes	panopes
tegean	tegeaeus
patron	patron
salius	salius
diores	diores
euryalus	euryalus
nisus	nisus
invite	invito
grassy	gramineus
pholoe	pholoe
restrain	retento
lame	claudus
limping	claudus
twisting	tortus
wayfarer	viator
traveler	viator
mangled	lacer
torn	lacer
covert	obliquus
indirect	obliquus
slanting	obliquus
maimed	debilis
disabled	debilis
ribbon	taenia
crown	evincio
crimson	puniceus
reddish	puniceus
struggle	conitor
sagaris	sagaris
phegeus	phegeus
defense	tutamen
concede	dono
give	dono
demoleos	demoleos
baying	latratus
barking	latratus
pant	anhelo
maeander	maeander
crimson	purpura
purple	purpura
special	praecipuus
peculiar	praecipuus
veil	advelo
reveal	declaro
auctioneer	praeco
herald	praeco
portunus	portunus
panopea	panopea
phorcus	phorcus
defendant	reus
incite	instigo
strip	spolio
brood	nidus
nest	nidus
porous	latebrosus
pole	contus
pole	trudis
creak	crepo
rattle	crepo
puffing	anhelitus
withdraw	subtraho
pursuing	sequax
following	sequax
malea	malea
vomit	revomo
drunk	madidus
wet	madidus
moist	madidus
nail	clavus
tiller	gubernaculum
helm	gubernaculum
menoetes	menoetes
director	rector
plow	sulco
resound	consono
whip	verber
charioteer	auriga
yoked	biiugus
prow	rostrum
beak	rostrum
cut	infindo
induce	adduco
seabird	mergus
gull	mergus
cluentius	cluentius
centaur	centaurus
line	versus
threefold	triplex
chimaera	chimaera
memmius	memmius
enter	ineo
talent	talentum
circle	circus
bordering	finitimus
phaethon	phaethon
acheron	acheron
devour	depasco
slippery	levis
smooth	levis
brightness	fulgor
flash	fulgor
lightning	fulgor
calmly	placide
gently	placide
circle	gyrus
imperative	salveo
well	salveo
bowl	carchesium
mature	maturus
helymus	helymus
dyspeptic	crudus
raw	crudus
bloody	crudus
apply	adhibeo
create	genero
sire	genero
parade	pompa
procession	pompa
understand	deprehendo
seize	deprehendo
catch	deprehendo
respected	honoratus
yearly	annuus
call	advoco
summon	advoco
crinisus	crinisus
bear	ursa
libyan	libystis
evening	vesper
bend	obliquo
why	quianam
slip	dilabor
dis	dis
dewy	roscidus
condemn	damno
proserpina	proserpina
iris	iris
death	obitus
downfall	obitus
difficult	difficilis
breath	halitus
breathing	halitus
fraud	fraus
shout	clamo
call	clamo
fist	pugnus
talon	unguis
claw	unguis
fingernail	unguis
yelling	ululatus
wailing	lamenta
imprint	imprimo
excessively	nimium
frenzied	furibundus
raging	furibundus
cheek	gena
mark	interfundo
besprinkle	interfundo
spot	macula
frantic	efferus
savage	efferus
expiatory	piaculum
barce	barce
report	trado
implore	imploro
exiled	extorris
attack	vexo
annoy	vexo
reckless	audax
bold	audax
limit	terminus
gutter	trivium
crossroads	trivium
grace	decet
become	decet
adorn	decet
naval	navalis
wow	pro
yellow	flaveo
mirror	speculum
tithonus	tithonus
eagerness	ardor
heat	ardor
burning	ardor
halter	retinaculum
flashing	fulmineus
scabbard	vagina
awake	vigilo
fickle	mutabilis
changeable	mutabilis
shine	conluceo
incite	concito
color	color
groans	questus
moaning	questus
complaining	questus
sychaean	sychaeus
pass	dego
lacking	expers
ruined	perditus
gratitude	gratia
influence	gratia
favor	gratia
therefore	igitur
wave	fluctuo
still	silens
bramble	dumus
melodious	liquidus
liquid	liquidus
clear	liquidus
loosen	recingo
mill	mola
snatch	praeripio
pubescent	pubens
harvest	meto
sickle	falx
scythe	falx
avernian	avernus
hecate	hecate
chaos	chaos
funereal	funereus
fringe	praetexo
paleness	pallor
couch	lectus
bed	lectus
hesperis	hesperis
fitting	aptus
appropriate	aptus
ethiopian	aethiops
decide	decerno
determine	decerno
conceive	concipio
produce	concipio
dira	dira
thebes	thebae
pentheus	pentheus
eumenides	eumenides
terrify	horrifico
terrifying	terribilis
prediction	praedictum
owl	bubo
fleece	vellus
marble	marmor
steady	assiduus
established	assiduus
cover	consterno
blast	flatus
wind	flatus
blowing	flatus
old	annosus
aged	annosus
stop	obstruo
space	spatium
swear	iuro
aulis	aulis
chastise	castigo
crops	frumentum
grain	frumentum
thrust	trudo
large	grandis
path	callis
carry	convecto
pile	acervus
heap	acervus
spelt	far
ant	formica
depart	migro
go	migro
unfashioned	infabricatus
unwrought	infabricatus
anoint	unguo
persist	exsequor
accomplish	exsequor
follow	exsequor
fail	conlabor
separate	seduco
punishment	supplicium
refute	refello
disparage	refello
seer	augur
prefer	antefero
whether	num
reserve	reservo
tiger	tigris
caucasus	caucasus
voluntarily	sponte
complaint	querela
cease	desino
cheat	fraudo
defraud	fraudo
remind	admoneo
admonish	admoneo
fiery	igneus
hide	operio
cover	operio
gryneian	gryneus
rebuilt	recidivus
returning	recidivus
theft	furtum
spirit	spiritus
breath	spiritus
elissae	elissa
deserve	promereor
enumerate	enumero
press	obnitor
advice	monitum
counsel	monitum
entirely	omnino
twig	suboles
shoot	suboles
destroy	destruo
since	quoniam
nomas	nomas
anothers	alienus
unrelated	alienus
strange	alienus
withdraw	decedo
false	perfidus
treacherous	perfidus
faithless	perfidus
cithaeron	cithaeron
nocturnal	nocturnus
triennial	trietericus
rouse	stimulo
spur	stimulo
thyias	thyias
poor	inops
lacking	inops
movement	motus
motion	motus
perform	facesso
swifter	ocior
mnestheus	mnestheus
there	illuc
origin	exordium
beginning	exordium
address	adfatus
encompass	ambio
silent	obmutesco
disappear	evanesco
heir	heres
leisure	otium
rub	tero
commission	mandatum
order	mandatum
web	tela
cloak	laena
jasper	iaspis
renew	novo
found	fundo
twig	planta
sprout	planta
winged	alatus
sandy	harenosus
bird	avis
cyllenian	cyllenius
ice	glacies
snow	nix
constantly	adsidue
perpetually	adsidue
reinforce	fulcio
fortify	fulcio
strengthen	fulcio
fould	turbidus
confused	turbidus
unseal	resigno
tartarus	tartarus
summon	evoco
stick	virga
blast	flamen
gust	flamen
sandals	talaria
sum	summa
peak	summa
envy	invideo
heavy	gravidus
claim	vindico
mercurius	mercurius
plunder	raptum
damp	madeo
wet	madeo
turban	mitra
headband	mitra
chin	mentum
suite	comitatus
payment	pretium
value	pretium
price	pretium
little	exiguus
small	exiguus
affright	terrifico
lenaeus	lenaeus
mauretanian	maurusius
moorish	maurusius
harsh	amarus
bitter	amarus
rumor	rumor
bloom	floreo
watch	excubiae
garamantian	garamantis
unworked	infectus
manifold	multiplex
messenger	nuntia
tenacious	tenax
crooked	pravus
falsehood	fictum
affright	territo
agile	pernix
bear	progigno
beget	progigno
coeus	coeus
maintain	perhibeo
exasperate	inrito
swiftness	mobilitas
moveableness	mobilitas
fast	velox
protect	praetego
furtive	furtivus
secret	furtivus
shine	fulgeo
dusty	pulverulentus
broad	patens
open	patens
dryopes	dryopes
cretan	cres
come	inviso
maternal	maternus
delos	delos
stream	fluentum
lycia	lycia
clasp	fibula
bind	nodo
border	limbus
delay	cunctor
horseman	eques
libyan	massylus
massylian	massylus
snare	plaga
net	plaga
trap	rete
net	rete
brightness	iubar
laugh	rideo
against	adversor
desire	voluntas
thunder	tonitrus
toils	indago
hail	grando
black	nigrans
beam	radius
ray	radius
titan	titan
rising	ortus
birth	ortus
hunt	venor
approve	probo
prefer	malo
deny	abnuo
refuse	abnuo
agree	paciscor
feel	persentio
interrupt	interrumpo
defense	propugnaculum
stick	harundo
reed	harundo
fatal	letalis
deadly	letalis
pasture	saltus
fleeting	volatilis
cretan	cressus
hind	cerva
middle	medulla
marrow	medulla
eat	edo
entrails	exta
plan	consulo
consult	consulo
inspect	inhio
cow	vacca
hoe	bidens
mattock	bidens
ignite	inflammo
ample	impensus
yielding	tractabilis
indulgent	tractabilis
rainy	aquosus
rage	desaevio
bind	innecto
thirst	sitis
unfriendly	inhospitus
unbridled	infrenus
numidian	numida
gaetulus	gaetulus
fight	pugno
agreeable	placitus
africa	africa
iarbas	iarbas
continuous	perpetuus
decency	pudor
erebus	erebus
pale	palleo
feeling	sensus
fraternal	fraternus
succumb	succumbo
torch	taeda
yoked	iugalis
accuse	arguo
declare	arguo
dream	insomnium
sleeplessness	insomnium
anna	anna
sound	sanus
vein	vena
recount	renarro
relief	levamen
joyless	inlaetabilis
drepanum	drepanum
selinus	selinus
breeder	generator
display	ostento
acragas	acragas
gela	gela
camarina	camarina
inscribe	rado
scratch	rado
shave	rado
projecting	proiectus
helorus	helorus
stagnant	stagno
arethusa	arethusa
beneath	subter
below	subter
elis	elis
stormy	undosus
billowy	undosus
plemyrium	plemyrium
sicanian	sicanus
sicilian	sicanus
back	retrorsus
backwards	retrorsus
thapsus	thapsus
pantagias	pantagias
pass	praetervehor
sail	linteum
sailcloth	linteum
napkin	linteum
cypress	cyparissus
aetnaean	aetnaeus
summon	excio
roar	immugio
powerful	potis
power	potestas
cut	incido
gnash	infrendeo
wash	lavo
running	fluidus
flowing	fluidus
solace	solamen
pleasure	voluptas
sheep	ovis
more	potius
rather	potius
sell	addico
stony	lapidosus
pearl	baca
berry	baca
tremble	tremesco
commonly	vulgo
squeeze	presso
polyphemus	polyphemus
light	lampas
wild	torvus
stern	torvus
bend	inflecto
moreover	quidem
tooth	dens
chew	mando
swim	nato
adamastus	adamastus
achaemenides	achaemenides
pledge	pignus
breathable	spirabilis
vital	spirabilis
terrify	conterreo
little	paulum
thorn	spina
dirt	inluvies
dress	cultus
civilization	cultus
cultivation	cultus
finish	conficio
emaciation	macies
remove	dimoveo
moist	umeo
wet	umeo
eous	eous
gloomy	intempestus
unpleasant	intempestus
unseasonable	intempestus
starry	sidereus
heaven	aethra
shining	lucidus
bright	lucidus
cover	subtexo
tremble	intremo
whenever	quotiens
forge	caminus
furnace	caminus
stove	caminus
enceladus	enceladus
melt	liquefacio
dissolve	liquefacio
vomit	eructo
globe	globus
ashes	favilla
brillant	candeo
shine	candeo
thunder	tono
cyclops	cyclops
kill	elido
crush	elido
troop	cohors
band	cohors
cohort	cohors
undoubtedly	nimirum
hit	pulso
aetna	aetna
scylaceum	scylaceum
shipwrecking	navifragus
caulon	caulon
tarentum	tarentum
herculean	herculeus
graiugena	graiugena
connected	continuus
reins	frenum
bridle	frenum
horse	quadrupes
snowy	nivalis
shining	candor
turreted	turritus
spray	aspargo
bend	curvo
greet	saluto
humble	humilis
agree	consto
censure	noto
sign	noto
mark	noto
seize	capto
slow	segnis
hour	hora
overshadow	umbro
ceraunia	ceraunia
finish	perago
appear	oborior
arise	oborior
equal	aequalis
woven	textilis
embroidered	picturatus
departure	digressus
beyond	ultra
necessary	necesse
glide	praeterlabor
seize	arripio
snatch	arripio
ausonia	ausonia
supply	suppleo
crest	crista
cone	conus
triple	trilix
hook	hamus
hauberk	lorica
dodonaean	dodonaeus
control	impero
command	impero
elephant	elephantus
willing	volens
loss	dispendium
expenditure	dispendium
sibylla	sibylla
situation	situs
transcribe	describo
describe	describo
note	nota
mark	nota
avernus	averna
cumaean	cumaeus
willing	libens
foresight	prudentia
resound	resono
dog	canis
shapeless	informis
once	semel
how	quam
as	quam
than	quam
pachynum	pachynus
coda	cauda
dolphin	delphinus
semonster	pistrix
next	posterus
beat	verbero
flog	verbero
whip	verbero
erect	erigo
absorb	sorbeo
suck	sorbeo
charybdis	charybdis
unappeased	implacatus
scylla	scylla
separate	diduco
age	vetustas
remote	longinquus
circle	circuitus
circuit	circuitus
pelorus	pelorus
open	raresco
pure	castus
across	trans
petelia	petelia
philoctetes	philoctetes
cretan	lyctius
lyctian	lyctius
locrian	locrus
repose	requies
lie	recubo
extended	recubo
recline	recubo
littoral	litoreus
worried	sollicitus
circe	circe
lower	infernus
welcoming	hospitus
that	quo
authority	auspicium
divination	auspicium
entreat	exoro
denounce	denuntio
prognostic	prodigium
replaced	repositus
successful	prosper
auspicious	prosper
favorable	prosper
fleet	praepes
swift	praepes
clarian	clarius
tripod	tripus
mediator	interpres
beg	quaeso
linen	carbasus
fill	inflo
middle	medium
enjoy	fruor
stream	rivus
brook	rivus
manly	virilis
who	quisnam
chaon	chaon
chaonia	chaonia
orestes	orestes
spartan	lacedaemonius
lacedaemonian	lacedaemonius
hermione	hermione
strive	enitor
struggle	enitor
haughtiness	fastus
achillean	achilleus
bed	cubile
couch	cubile
master	erus
allotment	sortitus
hostile	hostilis
modest	demissus
eject	deicio
gape	hisco
warmth	calor
alarm	exterreo
frighten	exterreo
turf	caespes
husband	maritus
helenus	helenus
priamides	priamides
anticipate	occupo
seize	occupo
incredible	incredibilis
buthrotum	buthrotum
chaonian	chaonius
phaeaces	phaeaces
thwart	transtrum
equipment	gestamen
raise	aspero
icy	glacialis
game	ludus
throw	iacio
dread	formido
point	cacumen
leucat	leucates
then	mox
soon	mox
execrate	exsecror
mother	altrix
nurse	altrix
ithaca	ithaca
neritos	neritos
same	same
dulichium	dulichium
zacynthus	zacynthus
woody	nemorosus
helmsman	gubernator
battlements	minae
threats	minae
beg	exposco
cold	derigesco
feather	penna
wing	penna
cheek	mala
consume	ambedo
before	antequam
fury	furia
foretell	praedico
laomedontiades	laomedontiades
bullock	iuvencus
lofty	praecelsus
down	pluma
feather	pluma
filthy	obscenus
misenus	misenus
lookout	specula
distribute	dispono
arrange	dispono
place	dispono
proclaim	edico
vile	taeter
disagreeable	taeter
foul	immundus
unclean	immundus
touch	contactus
terrible	horrificus
banquet	epulor
raise	exstruo
erect	exstruo
enter	intro
excrement	proluvies
foul	foedus
bird	volucris
stygian	stygius
harpyia	harpyia
celaeno	celaeno
ionian	ionius
ionic	ionius
strophades	strophades
sailor	nauta
fourth	quattuor
four	quattuor
mist	caligo
palinurus	palinurus
determine	discerno
sprinkle	dispergo
continuously	continuo
immediately	continuo
rough	inhorresco
above	supra
shout	ovo
stretch	portendo
cheat	decipio
deceive	decipio
accomplish	perficio
complete	perficio
vision	visum
astonished	attonitus
italian	ausonius
ausonius	ausonius
corythus	corythus
doubt	dubito
hesitate	dubito
iasius	iasius
dardanus	dardanus
delian	delius
traverse	permetior
confer	defero
report	defero
insert	insero
animal	animal
pray	precor
beg	precor
wither	areo
dry	areo
sirius	sirius
unfruitful	sterilis
unproductive	sterilis
pestilence	lues
pitied	miserandus
dragging	tractus
emaciated	tabidus
work	operor
almost	fere
fireplace	focus
love	amo
curetes	curetes
ancestor	proavus
struggle	certamen
contest	certamen
cyclades	cyclades
paros	paros
olearos	olearos
donus	donusa
naxos	naxos
rage	bacchor
revel	bacchor
ortygia	ortygia
idomeneus	idomeneus
paternal	paternus
white	albus
due	meritus
deserved	meritus
cretan	cretaeus
distant	disto
mistress	domina
corybantian	corybantius
protectress	cultrix
remember	recordor
fruitful	uber
fertile	uber
inhabit	habito
birthplace	cunabula
cradle	cunabula
crete	creta
monument	monumentum
memorial	monumentum
kettle	cortina
caldron	cortina
low	mugio
encircle	redimio
anius	anius
scorn	contemno
despise	contemno
gyaros	gyaros
myconos	myconos
aegean	aegaeus
nereis	nereis
creak	crepito
milk	lac
small	cymbium
tepid	tepidus
warm	tepidus
manes	manes
soil	polluo
sever	abrumpo
blockade	obsidio
siege	obsidio
distrust	diffido
northern	threicius
thracian	threicius
nourish	alo
entrust	mando
dangerous	anceps
unsettled	anceps
spear	iaculum
polydorus	polydorus
flow	mano
drip	mano
bloodshed	cruor
blood	cruor
strange	externus
foreign	externus
outside	externus
tear	lacero
disastrous	lacrimabilis
piteous	lacrimabilis
express	eloquor
strive	obluctor
exertion	nisus
pressure	nisus
favor	secundo
aid	secundo
correctly	rite
duly	rite
gradivus	gradivus
rustic	agrestis
rural	agrestis
venerate	veneror
cork	cortex
shell	cortex
bark	cortex
osier	vimen
slow	lentus
sticky	lentus
flexible	lentus
defile	maculo
stain	maculo
spot	maculo
gore	tabum
drop	gutta
run	liquor
root	radix
frondens	frondeo
leafy	frondeo
branch	ramus
green	viridis
myrtle	myrtus
thicket	virgultum
brambles	virgultum
diviner	auspex
enter	ingredior
lycurgus	lycurgus
thracian	thrax
collect	contraho
antandros	antandros
undeserving	immeritus
lucifer	lucifer
launch	deduco
wonder	admiror
admire	admiror
assemble	adfluo
consume	consumo
seize	comprehendo
unite	comprehendo
arm	brachium
attempt	conor
try	conor
thin	tenuis
hold	detineo
divine	divus
dardanis	dardanis
serve	servio
thybris	thybris
mild	lenis
kind	lenis
gentle	lenis
etruscan	lydius
lydian	lydius
western	hesperius
plough	aro
gratify	indulgeo
remove	demo
again	iterum
captured	captivus
watch	adservo
guard	adservo
preserve	adservo
phoenix	phoenix
temple	asylum
advance	procedo
greedy	edax
voracious	edax
observe	observo
watch	observo
beginning	principium
return	revertor
gleaming	fulgens
lacking	desum
weary	lassus
tired	lassus
pathless	avius
confused	confusus
mingled	confusus
dark	opacus
shady	opacus
footstep	passus
pace	passus
lion	leo
hide	pellis
skin	pellis
cover	insterno
old	vetustus
mound	tumulus
track	vestigium
trace	vestigium
wherever	quocumque
whithersoever	quocumque
load	gravo
burden	gravo
yield	cedo
now	iamiam
already	iamiam
smoke	fumo
sulphur	sulphur
border	limes
star	stella
strengthen	firmo
deserve	mereor
earn	mereor
prayer	prex
agitated	trepido
innocent	innoxius
harmless	innoxius
touch	tactus
touching	tactus
peak	apex
unexpected	subitus
protect	tutor
beyond	extra
outside	extra
unavenged	inultus
today	hodie
never	numquam
linger	demoror
sacrifice	iactura
loss	iactura
discover	invenio
find	invenio
solid	solidus
firm	solidus
dense	solidus
complete	integer
fresh	integer
untouched	integer
banishment	exilium
exile	exilium
deny	abnego
descend	descendo
nod	nuto
distract	concutio
disturb	concutio
terrify	concutio
strike	concutio
beat	concutio
shake	concutio
continuously	usque
neptunian	neptunius
last	imus
deepest	imus
thick	spissus
dense	spissus
close	spissus
gorgo	gorgo
effulgent	effulgo
scaea	scaea
shake	quatio
smoke	fumus
dark	caligo
impair	hebeto
inclemency	inclementia
unkindness	inclementia
lacaena	lacaena
arouse	excito
restrain	contineo
contain	contineo
god	caelicola
confess	confiteor
pure	purus
avenging	ultrix
praise	laudo
extinguish	exstinguo
victory	victoria
memorable	memorabilis
although	etsi
sweat	sudo
fall	occido
set	occido
marriage	coniugium
triumph	triumphus
sparta	sparta
certainly	scilicet
avenge	ulciscor
secret	invisus
unseen	invisus
general	communis
common	communis
helen	tyndaris
jump	saltus
creus	creusa
sovereign	regnator
departure	exitus
hilt	capulus
slip	lapso
recount	narro
report	narro
tell	narro
degenerate	degener
news	nuntius
messenger	nuntius
noisy	raucus
stroke	ictus
blow	ictus
peaceful	imbellis
unwarlike	imbellis
grave	sepulcrum
tomb	sepulcrum
blush	erubesco
plant	sero
ought	debeo
owe	debeo
outrage	ausum
exclaim	exclamo
aggressive	infestus
hostile	infestus
empty	vacuus
portico	porticus
colonnade	porticus
polites	polites
aged	longaevus
speak	effor
need	egeo
want	egeo
that	iste
protector	defensor
defender	defensor
youthful	iuvenalis
crowded	condensus
thick	condensus
dove	columba
pigeon	columba
laurel	laurus
close	iuxta
near	iuxta
sky	axis
axle	axis
unserviceable	inutilis
useless	inutilis
aged	senex
old	senex
fail	deficio
barbaric	barbaricus
foreign	barbaricus
bedchamber	thalamus
consecrate	sacro
hecuba	hecuba
brothel	stabulum
inn	stabulum
stable	stabulum
overcome	evinco
torrent	amnis
river	amnis
slaughter	trucido
entryway	aditus
door	ianua
ram	aries
worth	valeo
strong	valeo
support	suffero
frightened	pavidus
scared	pavidus
howl	ululo
feminine	femineus
shrine	aedes
building	aedes
lamentation	plangor
window	fenestra
strong	firmus
firm	firmus
pluck	vello
break	perrumpo
automedon	automedon
charioteer	agitator
periphas	periphas
slippery	lubricus
smooth	lubricus
bring	nitidus
shining	nitidus
winter	bruma
cold	frigidus
cool	frigidus
herb	gramen
plant	gramen
grass	gramen
snake	coluber
pyrrhus	pyrrhus
entrance	vestibulum
floor	tabulatum
planking	tabulatum
joint	iunctura
joining	iunctura
greek	achaicus
achaean	achaicus
void	irritus
invalid	irritus
evade	evado
astyanax	astyanax
grandfather	avus
unattended	incomitatus
andromache	andromache
use	usus
free	pervius
unobstructed	pervius
perform	instauro
build	instauro
throw	devolvo
tower	turris
grasp	prenso
protect	protego
conceal	protego
cover	protego
door	postis
doorjamb	postis
ladder	scalae
wall	paries
wild	indomitus
untamed	indomitus
nowhere	nusquam
age	aevum
lifetime	aevum
eternity	aevum
pelias	pelias
iphitus	iphitus
succession	vicis
change	vicis
turn	vicis
shun	vito
avoid	vito
foreign	exter
outward	exter
ashes	cinis
bandage	infula
transfix	configo
right	aequum
observant	servans
peneleus	peneleus
immediately	ilicet
mark	signo
disagreeing	discors
sound	sonus
lie	mentior
drive	agito
foundation	fundus
nereus	nereus
frothy	spumeus
foamy	spumeus
army	exercitus
attain	consequor
overtake	consequor
perish	pereo
throw	inicio
madden	furio
specter	species
image	species
appearance	species
tender	tener
believe	fido
trust	fido
unwilling	invitus
back	rursus
ugly	turpis
orcus	orcus
join	consero
arm	armo
equip	armo
hairy	comans
decoration	insigne
medal	insigne
right	dexter
exult	exsulto
ecstatic	exsulto
fear	formido
dense	densus
thick	densus
differently	secus
otherwise	secus
agitated	trepidus
thorn	sentis
restrain	reprimo
glide	delabor
response	responsum
sloth	segnities
hurry	festino
allied	socius
androgeos	androgeos
superstitious	religiosus
reverent	religiosus
lazy	iners
unskilled	iners
explain	explico
untangle	explico
destruction	clades
go	vado
dry	siccus
mouth	faux
belly	venter
stomach	venter
plunderer	raptor
as	ceu
wolf	lupus
craving	cupido
desire	cupido
rule	praeceptum
precept	praeceptum
insane	insanus
mygdonides	mygdonides
coroebus	coroebus
young	iuvenis
youthful	iuvenis
gather	agglomero
dymas	dymas
hypanis	hypanis
epytus	epytus
ripheus	ripheus
murmuring	fremitus
erinys	erinys
battle	proelium
narrow	angustus
blockade	obsideo
difficult	arduus
steep	arduus
fierce	ferus
wild	ferus
snatch	prehendo
grasp	prehendo
othryades	othryades
panthus	panthus
die	morior
method	ratio
insane	amens
mad	amens
trumpet	tuba
braying	clangor
proceed	exorior
ucalegon	ucalegon
vulcan	vulcanus
deiphobus	deiphobus
manifest	manifestus
clear	manifestus
headlong	praeceps
ox	bos
grain	sata
torrent	torrens
withdraw	recedo
secret	secretus
hidden	secretus
separated	secretus
innermost	penetralis
approve	commendo
recommend	commendo
entrust	commendo
top	culmen
nothing	nihil
calm	serenus
serene	serenus
unworthy	indignus
expect	exspecto
dardania	dardania
explain	expromo
cry	fleo
stiffen	concresco
beard	barba
rough	squaleo
garment	exuviae
swell	tumeo
car	bigae
weeping	fletus
creep	serpo
sleepless	vigil
bury	sepelio
epeius	epeos
constructor	fabricator
menelaus	menelaus
machaon	machaon
neoptolemus	neoptolemus
pelides	pelides
thoas	thoas
acamas	acamas
sthenelus	sthenelus
thessandrus	thessandrus
take	promo
reveal	patefacio
uneven	iniquus
defend	defendo
battalion	phalanx
sound	sopor
sleep	sopor
leaf	frons
cover	velo
festive	festus
sacred	festus
farthest	ulterior
farther	ulterior
command	iussus
order	iussus
cassandra	cassandra
forgetful	immemor
unmindful	immemor
halt	subsisto
fall	illabor
glide	illabor
line	funis
rope	funis
girl	puella
climb	scando
strain	intendo
stretch	intendo
shout	conclamo
criminal	sceleratus
deserve	mereo
earn	mereo
trembling	pavor
fear	pavor
penetrate	insinuo
embosom	insinuo
shake	tremefacio
escape	effugio
flee	effugio
shrine	delubrum
gliding	lapsus
slipping	lapsus
axe	securis
drunk	saucius
afflicted	saucius
wounded	saucius
bellowing	mugitus
lowing	mugitus
dreadful	horrendus
putrid	sanies
wash	perfundo
scaly	squameus
bind	ligo
tie	ligo
fold	spira
consume	depascor
embrace	amplector
snake	serpens
two	duo
sight	visus
shake	vibro
language	lingua
tongue	lingua
lick	lambo
hissing	sibilus
suffuse	sufficio
noise	sonitus
sounding	sonitus
roll	volumen
book	volumen
coil	sinuo
behind	pone
bloodshot	sanguineus
bloody	sanguineus
snake	anguis
bristle	horresco
still	tranquillus
calm	tranquillus
kill	macto
reward	macto
punish	macto
customary	sollemnis
dreadful	tremendus
greatly	multo
tehth	decem
ten	decem
dominate	domo
subdue	domo
larissaean	larisaeus
lie	periurium
descendant	nepos
grandchild	nepos
greek	pelopeus
argive	pelopeus
pelopeian	pelopeus
rather	prius
to	prius
before	prius
preceding	prius
earlier	prius
violate	violo
form	texo
weave	texo
strength	robur
oak	robur
immense	immensus
advise	moneo
warn	moneo
arrange	digero
separate	digero
shine	emico
leap	emico
sweat	sudor
statue	simulacrum
likeness	simulacrum
monster	monstrum
omen	monstrum
tritonian	tritonius
backwards	retro
maidenly	virgineus
effigy	effigies
image	effigies
portrait	effigies
holy	sacer
palladium	palladium
pluck	avello
approach	adgredior
fatal	fatalis
fated	fatalis
contriver	inventor
finder	inventor
promise	promissum
cover	tego
hate	odi
untie	resolvo
sword	ensis
testify	testor
inviolable	violabilis
violable	violabilis
scruple	religio
rite	religio
founder	auctor
ask	rogo
state	edissero
forget	obliviscor
so	ita
pity	misereor
chaste	intemeratus
undefiled	intemeratus
truth	verum
because	quod
blame	culpa
fault	culpa
perchance	fors
haply	fors
lurk	delitesco
hide	delitesco
reservoir	lacus
lake	lacus
miry	limosus
death	letum
ribbon	vitta
temple	tempus
witty	salsus
salted	salsus
ruin	exitium
destruction	exitium
every	quisque
each	quisque
and	adsentio
intend	destino
determine	destino
break	rumpo
compact	compositum
refuse	recuso
covered	tectus
demand	flagito
draw	protraho
confusion	tumultus
poet	vates
apollo	apollo
tremor	tremor
quaking	tremor
trembling	tremor
icy	gelidus
cold	gelidus
atone	lito
cut	caedo
strike	caedo
kill	caedo
prophecy	oraculum
oracle	oraculum
eurypylus	eurypylus
construct	contexo
hinder	intercludo
depart	discedo
desire	cupio
feigned	fictus
tremble	pavito
follow	prosequor
inquire	scitor
ascertain	scitor
ithacan	ithacus
consume	sumo
enough	satis
unpleasant	ingratus
moreover	autem
however	autem
calchas	calchas
rest	requiesco
falling	labes
punisher	ultor
avenger	ultor
ever	umquam
raving	demens
mad	demens
silent	taceo
darkness	tenebrae
life	vita
concede	concedo
allow	concedo
withdraw	concedo
deceitful	pellax
jealousy	invidia
envy	invidia
assembly	concilium
union	concilium
flourish	vigeo
uninjured	incolumis
humble	pauper
poor	pauper
related	propinquus
near	propinquus
kinship	consanguinitas
companion	comes
grieve	lugeo
mourn	lugeo
futile	cassus
void	cassus
murder	nex
killing	nex
because	quia
evidence	indicium
information	indicium
innocent	insons
abandonment	proditio
betrayal	proditio
glory	gloria
renown	gloria
glorious	inclutus
famous	inclutus
palamedes	palamedes
belides	belides
reach	pervenio
bad	improbus
deceitful	mendax
false	mendax
invent	fingo
shape	fingo
sinon	sinon
refuse	nego
deny	nego
admit	fateor
confess	fateor
increase	cresco
grow	cresco
attack	impetus
compress	comprimo
angry	infensus
hostile	infensus
near	apud
finally	denique
survey	circumspicio
accusation	crimen
verdict	crimen
bold	fidens
trusting	fidens
voluntarily	ultro
beyond	ultro
furthermore	ultro
shepherd	pastor
behold	ecce
defile	foedo
greek	argolicus
argolic	argolicus
left	laevus
resound	insono
curved	curvus
machine	machina
construct	fabrico
conceal	occulto
hide	occulto
firewood	lignum
without	careo
think	puto
citizen	civis
madness	insania
laocoon	laocoon
then	ibi
there	ibi
uncertain	incertus
concealment	latebra
pierce	terebro
suspicious	suspectus
urge	hortor
within	intra
thymoetes	thymoetes
minerva	minerva
fatal	exitialis
destructive	exitialis
abandon	relinquo
abandon	desero
leave	desero
doricus	doricus
teucria	teucria
think	reor
abandoned	desertus
desolate	desertus
ship	carina
keel	carina
badly	male
standing	statio
tenedos	tenedos
armed	armatus
cavern	caverna
hollow	caverna
enclose	includo
stealthily	furtim
obtain	sortior
choose	deligo
revenue	reditus
return	reditus
establish	aedifico
erect	aedifico
build	aedifico
grief	luctus
mourning	luctus
dread	horreo
although	quamquam
damp	umidus
moist	umidus
ulysses	ulixes
soldier	miles
dolopes	dolopes
myrmidones	myrmidones
unearth	eruo
deplorable	lamentabilis
renew	renovo
refresh	renovo
restore	renovo
still	conticesco
error	error
wandering	error
ambush	insidiae
diomedes	diomedes
aurora	aurora
dawn	aurora
clapping	plausus
beating	plausus
repeat	ingemino
slow	tardus
color	tingo
dye	tingo
moisten	tingo
wet	tingo
hasten	propero
only	tantum
rainy	pluvius
arcturus	arcturus
moon	luna
atlas	atlans
gild	auro
sing	persono
iopas	iopas
elder	procer
chief	procer
aristocrat	procer
nobleman	procer
swallow	haurio
drink	haurio
drain	haurio
bitias	bitias
touch	attingo
favor	faveo
celebrate	celebro
frequent	celebro
giver	dator
host	hospes
stranger	hospes
guest	hospes
silence	silentium
accustomed	soleo
wine	merum
lamp	lychnus
hang	dependeo
court	atrium
atrium	atrium
become	fio
surround	corono
crown	corono
seated	reses
try	tento
begin	incipio
abolish	aboleo
gradually	paulatim
acidalian	acidalius
sink	insido
unaware	inscius
sometimes	interdum
embrace	complexus
unable	nequeo
dedicate	devoveo
plague	pestis
paint	pingo
word	verbum
burn	flagro
embroidered	pictus
swelling	torum
cushion	torum
couch	torum
bed	torum
often	frequens
servant	minister
attendant	minister
like	par
equal	par
construct	struo
victuals	penus
provision	penus
maidservant	famula
fiftieth	quinquaginta
fifty	quinquaginta
handcloth	mantele
finish	tondeo
shear	tondeo
baskets	canistra
basket	canistra
water	lympha
couch	sponda
curtain	aulaeum
embrace	complector
flower	flos
marjoram	amaracus
gentle	mollis
yielding	mollis
idalia	idalia
water	inrigo
rest	quies
sleep	quies
glad	gaudeo
strip	exuo
poison	venenum
inspire	inspiro
secret	occultus
hidden	occultus
lyaeus	lyaeus
wine	latex
liquor	latex
liquid	latex
bosom	gremium
lap	gremium
clothe	induo
deceive	fallo
generous	amplus
ample	amplus
large	amplus
spacious	amplus
holy	sacratus
idalium	idalium
cyther	cythera
summons	accitus
rehearse	meditor
think	meditor
cease	cesso
fear	vereor
delay	moror
pleasant	blandus
flattering	blandus
phoenissus	phoenissus
know	nosco
learn	nosco
bitter	acerbus
flee	confugio
typhoian	typhoeus
power	potentia
address	adfor
winged	aliger
therefore	ergo
cruel	atrox
terrible	atrox
burn	uro
doubtful	ambiguus
uncertain	ambiguus
fear	timeo
involve	implico
bone	os
burn	incendo
cupid	cupido
change	muto
face	facies
appearance	facies
crown	corona
garland	corona
gem	gemma
jewel	gemma
necklace	monile
neck	collum
leda	leda
marriage	hymenaeus
helen	helena
garment	velamen
covering	velamen
stiffen	rigeo
stiff	rigeo
cloak	palla
carve	caelo
work	laboro
talent	ars
skill	ars
feast	convivium
banquet	convivium
arrange	instruo
furnish	instruo
excess	luxus
splendid	splendidus
brilliant	splendidus
clear	splendidus
shining	splendidus
kingly	regalis
regal	regalis
duty	munus
gift	munus
lamb	agnus
pig	sus
bull	taurus
twentieth	viginti
twenty	viginti
announce	indico
proclaim	indico
learn	disco
finally	demum
follow	succedo
therefore	quare
why	quare
stalk	stirps
stem	stirps
born	orior
rise	orior
greek	pelasgus
pelasgian	pelasgus
inquire	cognosco
understand	cognosco
learn	cognosco
cyprus	cyprus
fertile	opimus
rich	opimus
belus	belus
paternal	patrius
expel	expello
propel	expello
sidon	sidon
anchises	anchises
danger	periculum
speak	loquor
sight	aspectus
serestus	serestus
always	semper
run	curro
river	fluvius
right	rectum
conscious	conscius
anywhere	usquam
scatter	spargo
everywhere	ubique
worthy	dignus
pay	persolvo
thanks	grates
share	socio
needy	egenus
exhaust	exhaurio
drain	exhaurio
only	solus
alone	solus
unforeseen	improvisus
stone	lapis
yellow	flavus
golden	flavus
ivory	ebur
youth	iuventa
mother	genetrix
handsome	decorus
suitable	decorus
fitting	decorus
oppose	resisto
clean	purgo
suddenly	repente
answer	respondeo
absent	absum
away	absum
address	compello
expel	eicio
present	adsum
drive	compello
trojan	tros
settle	consido
alike	pariter
eryx	eryx
so	adeo
enfeebled	obtusus
fire	incendium
courage	virtus
manliness	virtus
guardian	custos
newness	novitas
harsh	durus
hard	durus
speak	profor
say	profor
dardanides	dardanides
sicania	sicania
channel	fretum
straight	fretum
resist	resto
consume	absumo
reduce	absumo
join	apto
prepare	apto
remove	subduco
raise	subduco
compete	certo
fight	certo
duty	officium
service	officium
lie	occubo
still	adhuc
eat	vescor
unutterable	nefandus
lawful	fandus
proper	fandus
speakable	fandus
despise	temno
human	humanus
cause	cieo
permit	permitto
savage	barbarus
barbarous	barbarus
foreign	barbarus
so	tam
trackless	invius
insolent	procax
bold	procax
orion	orion
rainy	nimbosus
stormy	nimbosus
rise	adsurgo
small	parvus
soil	glaeba
clod	glaeba
udder	uber
hesperia	hesperia
pride	superbia
plunder	populo
prevent	prohibeo
righteousness	iustitia
begin	coepi
troops	copia
abundance	copia
publicly	coram
openly	coram
enter	introgredior
pardon	venia
plead	oro
pray	oro
relinquish	linquo
leave	linquo
surround	amicio
clothe	amicio
cover	amicio
watch	speculor
dissemble	dissimulo
conceal	dissimulo
unperceived	incognitus
unnoticed	incognitus
unknown	incognitus
happiness	laetitia
joy	laetitia
kill	percutio
strike	percutio
astonished	obstipesco
separate	dispello
sergestus	sergestus
crowd	concursus
concourse	concursus
fair	iustus
just	iustus
law	lex
shrink	resido
seat	solium
tortoise	testudo
joy	gaudium
test	pertempto
silent	tacitus
latona	latona
oreas	oreas
dance	chorus
dian	diana
cynthus	cynthus
ridge	iugum
yoke	iugum
bank	ripa
crowd	caterva
band	caterva
look	obtutus
bewildered	stupeo
wonderful	mirandus
trojan	dardanus
dardanian	dardanus
assemble	concurro
momma	mamma
girdle	cingulum
expose	exsero
golden	aureus
glow	ardeo
burn	ardeo
thousandth	mille
thousand	mille
penthesilea	penthesilea
amazonis	amazonis
memnon	memnon
wicked	niger
unlucky	niger
black	niger
edge	acies
eastern	eous
first	princeps
chief	princeps
unarmed	inermis
friendly	amicus
groan	gemitus
groaning	gemitus
certainly	vero
sell	vendo
lifeless	exanimus
breathless	exanimus
drag	rapto
beat	tundo
robe	peplum
mantle	peplum
explain	pando
hair	crinis
equal	aequus
spear	hasta
dust	pulvis
engage	congredior
meet	congredior
unequal	impar
unhappy	infelix
unfortunate	infelix
troilus	troilus
drink	bibo
taste	gusto
food	pabulum
camp	castra
killing	caedes
tent	tentorium
snowy	niveus
rhesus	rhesus
plumed	cristatus
crested	cristatus
phryges	phryges
youth	iuventus
greek	graecus
pergamum	pergama
river	flumen
moisten	umecto
ample	largus
void	inanis
empty	inanis
feed	pasco
painting	pictura
any	aliquis
some	aliquis
something	aliquis
someone	aliquis
touch	tango
fortunes	mortalia
glory	laus
praise	laus
reward	praemium
look	en
region	regio
weep	lacrimo
cry	lacrimo
both	ambo
priamus	priamus
circulate	vulgo
publish	vulgo
fight	pugna
battle	pugna
expect	opperior
wait	opperior
separate	singuli
review	lustro
survey	lustro
trust	confido
assured	confido
well	bene
dejected	adflictus
health	salus
hope	spero
alleviate	lenio
present	offero
offer	offero
hinge	cardo
door	foris
weave	necto
connect	necto
bind	necto
tie	necto
position	gradus
step	gradus
goddess	diva
opulent	opulentus
rich	opulentus
gift	donum
sidonian	sidonius
easy	facilis
uncommon	egregius
distinguished	egregius
royal	regius
sign	signum
impression	signum
mark	signum
wood	lucus
grove	lucus
extraordinary	mirabilis
wonderful	mirabilis
accept	suspicio
recognize	suspicio
happy	fortunatus
fortunate	fortunatus
lucky	fortunatus
fragrant	fragro
boil	ferveo
trough	praesaepe
manger	praesaepe
herd	pecus
drone	fucus
lazy	ignavus
burden	onus
load	onus
room	cella
nectar	nectar
extend	distendo
honey	mel
fluid	liqueo
mature	adultus
ripe	adultus
exercise	exerceo
train	exerceo
country	rus
flowery	floreus
bee	apis
glory	decus
ornament	decus
beauty	decus
column	columna
foundation	fundamentum
theater	theatrum
senate	senatus
consecrated	sanctus
read	lego
collect	lego
choose	lego
magistracy	magistratus
furrow	sulcus
roof	tectum
wall	murus
burning	ardens
coverlet	stratum
bedding	stratum
din	strepitus
noise	strepitus
huts	magalia
astonished	miror
wonder	miror
hill	collis
ascend	ascendo
lane	semita
breathe	halo
fresh	recens
garlands	serta
glow	caleo
warm	caleo
incense	tus
arabian	sabaeus
sabaean	sabaeus
temple	templum
paphos	paphos
demand	posco
delay	mora
devise	molior
neither	neu
nor	neu
encompass	circumfundo
cloud	nebula
enclose	saepio
dark	obscurus
covered	obscurus
accuse	incuso
return	reddo
why	cur
false	falsus
deceptive	falsus
son	natus
recognize	agnosco
walk	incessus
true	verus
real	verus
clothing	vestis
foot	pes
breathe	spiro
scent	odor
divine	divinus
ambrosial	ambrosius
neck	cervix
rosy	roseus
step	gressus
stepping	gressus
full	plenus
differently	aliter
otherwise	aliter
song	cantus
melody	cantus
seize	capio
row	ordo
disturb	turbo
bird	ales
zone	plaga
tract	plaga
heavenly	aetherius
swan	cycnus
glad	laetor
rejoice	laetor
prophecy	augurium
safety	tutum
announce	nuntio
endure	perfero
threshold	limen
only	modo
arrive	advenio
criticize	carpo
seize	carpo
pluck	carpo
vital	vitalis
whichever	quisquis
whoever	quisquis
interrupt	interfor
complain	queror
strike	pello
drive	pello
asia	asia
europ	europa
roam	peragro
wastes	deserta
destitute	egens
pluck	convello
bring	appello
luck	fors
chance	fors
olympus	olympus
vesper	vesper
empty	vaco
proceed	pergo
drag	traho
sigh	suspiro
journey	iter
where	quo
surround	circumdo
byrsa	byrsa
bottom	solum
traffic	mercor
rise	surgo
wife	femina
woman	femina
general	dux