ward_off_by_earnest_prayer	deprecor
sevenfold	septemplex
thunder_clap	crepitus
din	crepitus
pertaining_walls	muralis
sink_down	succido
fall_down	succido
attempt	conatus
languid	languidus
quarrel	lis
lawsuit	lis
cover	contego
status	condicio
situation	condicio
agreement	condicio
numbness	torpor
beat_violently	everbero
late_at_night	serum
the_dead_of_night	serum
incurable	immedicabilis
Megaera	Megaera
majesty	maiestas
greatness	maiestas
swear_by	adiuro
Heroes_elevated_gods_after_death	Indigetes
loosen	discludo
open	discludo
the_wild_olive	oleaster
trivial	ludicer
vain	ludicer

weave_again	retexo
threaten	minitor
demand	efflagito
ask_urgently	efflagito
echo	responso
make_answer	responso
Umbrian	Umber
glitter	resplendeo
shine_brightly	resplendeo
go_down	vergo
incline	vergo
command	imperito
Taburnus	Taburnus
Sila	Sila
Apennines	Appenninus

hold_back	inhibeo
indicate	significo
join_together	compingo
flash/strike_like_lightning	fulmino
Saces	Saces
tear_asunder	discindo
attack	incesso
happen	accido
fall	accido
of_wax	cereus
waxen	cereus
is_pleasing	libet
it_pleases	libet
free_from_service	immunis
Lyrnesus	Lyrnesus
an_over_thrower	eversor
Cupencus	Cupencus
Hyllus	Hyllus
tread_down	proculco
Murranus	Murranus
ransack	populor
ravage	populor
lay_waste	populor
running_down	decursus
rent	conduco
hire	conduco
bring_together	conduco
Peridia	Peridia
Theban	Echionius
Echionian	Echionius
of_Echion	Echionius
Onites	Onites
Cethegus	Cethegus
Tanais	Tanais
Talos	Talos
cut_off	abscido
Sucro	Sucro
turn_one’s_self	diverto
rapid	incitus
food	esca
swallow	hirundo
fly_through_or_over	pervolo
wagon	temo
the_tongue_or_pole_of_plow_or_cart	temo
Metiscus	Metiscus
heroine	virago
woman_of_masculine_spirit	virago
Epulo	Epulo
Arcetius	Arcetius
Osiris	Osiris
grow_up	adolesco
kiss	delibo
sip	delibo
come_about	provenio
come_forth	provenio
all_heal	panacea
an_herb_which_cured_all_diseases	panacea
sweet_scented	odorifer
juice	sucus
ambrosia	ambrosia
healthy	salubris
stalk	caulis
pubescent	pubes
youthful	pubes
dittany	dictamnus
aid	subvenio
medical	medicus
healing	medicus
running_forward	procursus
touch	degusto
taste_of	degusto
double_plaited	bilix
lance	lancea
swiftly_driven_or_swiftly_running	citatus
Edonic	Edonus
throwing_rider	sternax
plunging	sternax
Sybaris	Sybaris
Asbytes	Asbytes
measure	metior
wrench_away	extorqueo
twist_out	extorqueo
come_over_or_come_unexpectedly	supervenio
void_space	inane
visit_with	afficio
affect	afficio
spy	speculator
courier	speculator
Dolon	Dolon
Eumedes	Eumedes
Imbrasus	Imbrasus
Lades	Lades
Thamyrus	Thamyrus
mix_by_trampling	calco
trample_upon	calco
put_under_the_heel	calco
wretchedly	miserabile
Thrace	Thraca
trample_upon_or_down	protero
rub_before	protero
sudden	repens
overhang	superimmineo
Alsus	Alsus
Podalirius	Podalirius
vapor	nidor
Ebusus	Ebusus
burn_round	amburo
victim	victima
an_animal_offered_in_sacrifice	victima
of_beams	trabalis
put_flight	proterreo
frighten_forth_or_away	proterreo
rein	infreno
furnish_with_bridle	infreno
bold	animosus
courageous	animosus
Gylippus	Gylippus
hissing	stridulus
conceal	obscuro
beautiful	excellens
surpassing	excellens
reduce	recido
cut_away	recido
consecrate	sancio
shrine	sacrarium
token	specimen
means_of_seeing_or_knowing	specimen
pertaining_four_horse_team	quadriiugus
pour	profundo
pour_forth	profundo
Juturna	Iuturna
rest	reclino
recline	reclino
armed_with_the_javelin	pilatus
laurel	verbena
flax_or_hemp	linum
measure	dimetior
exalted	elatus
high	elatus
prepare_for	proludo
play_or_practice_beforehand	proludo
myrrh	murra
gum_of_the_myrrh_tree	murra
the_myrrh_tree	murra
summons	vocatus
calling	vocatus
brass	orichalcum
mountain_copper	orichalcum
surpass	anteeo
go_before	anteeo
Orithyia	Orithyia
Idmon	Idmon
rose	rosa
make_hot	calefacio
redness	rubor
tilt	inclino
bend	inclino
influence	inclino
within_one's_power	penes
heal	medeor
become_sick	aegresco
not_at_all	haudquaquam
by_no_means_whatever	haudquaquam
disprove	refuto
repel	refuto
receive	adscio
ally	adscio
white	albeo
warm_or_hot	recaleo
composed	sedatus
renegade	desertor
one_who_has_deserted	desertor
grow	glisco
robber	latro
unappeasable	implacabilis
encamp_around	vallo
surround_with_rampart	vallo
dash	arieto
stumble	arieto
strike	arieto
galloping	quadrupedus
going_on_four_feet	quadrupedus
Atinas	Atinas
Dercennus	Dercennus
maltreat	mulco
beat	mulco
Acca	Acca
hide	remulceo
fondle	remulceo
stroke_back	remulceo
breast	papilla
nipple	papilla
of_linen	carbaseus
metal_helmet	cassis
Cretan	Gortynius
Gortynian	Gortynius
of_Gortyn	Gortynius
foreign	peregrinus
Chloreus	Chloreus
wherever	quacumque
by_whatever_way	quacumque
go_around	circumeo
Arruns	Arruns
Maeonidae	Maeonidae
example	exemplum
sample	exemplum
sinuous	sinuosus
full_of_windings	sinuosus
eagle	aquila
fight_against	repugno
break_off	defringo
opposed	adversus
against	adversus
opposite	adversus
facing	adversus
want_of_spirit	ignavia
disembowel	eviscero
hawk	accipiter
fly_away	avolo
Aunus	Aunus
Appenninicola	Appenninicola
redouble	congemino
mock	eludo
disprove	redarguo
feminine	muliebris
female	muliebris
of_or_belonging_woman	muliebris
rustic_weapon_having_an_iron_head_with_projecting_hook_or_blade	sparus
adjectively	pugnator
fighter	pugnator
huntsman	venator
Ornytus	Ornytus
Chromis	Chromis
Demophoon	Demophoon
Harpalycus	Harpalycus
Tereus	Tereus
Hippotades	Hippotades
Amastrus	Amastrus
Pagasus	Pagasus
Liris	Liris
Euneus	Euneus
Hippolyte	Hippolyte
Thermodon	Thermodon
attendant	ministra
servant	ministra
Italian_women_or_nymphs	Italides
Tarpeia	Tarpeia
Tulla	Tulla
Larina	Larina
unwearied	indefessus
wearing_quiver	pharetratus
Amazon	Amazon
Herminius	Herminius
Iollas	Iollas
leg	crus
shin	crus
unable_tolerate	impatiens
impatient	impatiens
Orsilochus	Orsilochus
suck_back	resorbeo
overcast	superiacio
throw_above_or_over	superiacio
Aconteus	Aconteus
Tyrrhenus	Tyrrhenus
cover	obtexo
weave_over	obtexo
reach	iactus
shot	iactus
leap	iactus
cast	iactus
precisely	numero
upon	inspoliatus
not_despoiled	inspoliatus
virginity	virginitas
swan	olor
lip	labrum
milk_into	immulgeo
of_the_herd	armentalis
fierceness	feritas
tie_or_bind_round_or_to	circumligo
book	liber
full	abundans
overflowing	abundans
Casmilla	Casmilla
Metabus	Metabus
Privernum	Privernum
delight	dulcedo
sweetness	dulcedo
Latonia	Latonia
Opis	Opis
recantation	receptus
retraction	receptus
level_surface	planities
fit	accommodus
the_winding_of_way_in_and_out	anfractus
breaking_round	anfractus
hollow	convexus
scout	explorator
luxuriant	luxurio
mare	equa
protector	praeses
perfume	vaporo
fumigate	vaporo
send_out_steam	vaporo
matron	matrona
dig_before_or_in_front_of	praefodio
company	manipulus
an_infantry_unit	manipulus
Volusus	Volusus
chirping	loquax
talkative	loquax
Padusa	Padusa
disagreement	dissensus
blessing	bonum
good	bonum
good_thing	bonum
Tolumnius	Tolumnius
solid_ground	solidum
bite	mordeo

going_back	regressus
embitter	acerbo
Aufidus	Aufidus
Adriatic	Hadriacus
deservedly	merito
eloquence	eloquium
just_as	proinde
hold_at_bay	distineo
unlamented	infletus
cheap	vilis
make_solitary	desolo
inviolable	inviolabilis
violence	violentia
mutter	musso
speak_low	musso
fame	nobilitas
weak	futilis
vain	futilis
chair_of_state	sella
chair	sella
seat	sella
material	materies
call_aid	adscisco
ally	adscisco
adopt	adscisco
troublesome	importunus
resemble	assideo
watch_over	assideo
sit_by	assideo
address_first	praefor
roaring	fremor
beware	caveo
Greece	Graecia
grasp	appeto
make_for	appeto
tearful	lacrimosus
dreadful	horribilis
Mycenaean	Mycenaeus
of_Mycenae	Mycenaeus
in_exile	exsulo
quite_to	ad_usque
Proteus	Proteus
Caphereus	Caphareus
draw_or_bring_to	attraho
Garganus	Garganus
Argyripa	Argyripa
outlay	impensa
darken	obumbro
overshadow	obumbro
aggravate	ingravo
make_heavy	ingravo
bereft	orbus
opulent	praedives
wealthy	praedives
bury	infodio
dig_in	infodio
invert	inverto
turn_over	inverto
funeral_pile	bustum
the_mound_where_the_dead_have_been_burned	bustum
slay	iugulo
cut_the_throat	iugulo
untimely	immaturus
remaining_alive_after_death	superstes
surviving	superstes
first_lesson	rudimentum
beginning	rudimentum
very_sweet	perdulcis
prudent	cautus
careful	cautus
cautious	cautus
beat	plango
make_distinct	discrimino
separate	discrimino
of_omen	praenuntius
foreboding	praenuntius
cart	plaustrum
an_ash_tree	fraxinus
two_edged	bipennis
two_winged	bipennis
sequestrpace	sequester
one_with_whom_something_is_placed_in_trust	sequester
Drances	Drances
limit	finio
finish	finio
refuse	aspernor
repel	aspernor
slight	aspernor
an_olive	olea
Aethon	Aethon
cover_up	obnubo
hyacinth	hyacinthus
violet	viola
big_toe	pollex
thumb	pollex
cut_off	demeto
reap	demeto
couch	stramen
something_spread_out	stramen
shade	inumbro
overshadow	inumbro
cast_shade_upon	inumbro
covering	obtentus
spreading_over	obtentus
oaken	quernus
of_the_arbutus	arbuteus
present	intersum
between	intersum
protection	praesidium
shameful	pudendus
that_one_should_ashamed_of	pudendus
equally	aeque
Acoetes	Acoetes
anticipate	praesumo
take_beforehand	praesumo
first_offerings	primitiae
the_first_fruits	primitiae
dig_or_pierce_through	perfodio
powerful_in_war	bellipotens
having_common_lot	consors
with_head_or_face_prone_downward	cernuus
ride	equito
horseman	equito
hairy	hirsutus
rough	hirsutus
accustomed_to	consuesco
accustom	consuesco
Rhaebus	Rhaebus
disfigure	deformo
hanging_down	propexus
leaning_on_or_against	acclinis
hair	capillus
soil	turpo
make_indecent	turpo
uplift	sublevo
lift_from_beneath	sublevo
genius	indoles
natural_disposition	indoles
that_which_is_bred_within	indoles
weave	neo
spin	neo
thunder_loudly	detono
it_is_raining	pluit
ploughman	arator
impede	inligo
attach_to	inligo
bind_on	inligo
famed	memorandus
worthy_of_mention	memorandus
recall	reminiscor
call_mind	reminiscor
Antores	Antores
vow	voveo
undaunted	imperterritus
Nealces	Nealces
Thronius	Thronius
Valerus	Valerus
Agis	Agis
Ericetes	Ericetes
of_or_descended_from_Lycaon	Lycaonius
of_Lycaoni	Lycaonius
Orses	Orses
very_hard	praedurus
Rapo	Rapo
Parthenius	Parthenius
Hydaspes	Hydaspes
Sacrator	Sacrator
Alcathous	Alcathous
throw_down/away	abicio
Orodes	Orodes
make_bloody	cruento
kind_of_wild_goat	caprea
Acron	Acron
shake_off	decutio
grow_angry	irascor
rage	infremo
bellow	infremo
reedy	harundineus
Vesulus	Vesulus
Theano	Theano
Mimas	Mimas
Euanthes	Euanthes
Palmus	Palmus
Latagus	Latagus
Dolichaon	Dolichaon
disgrace	dedecus
shame	dedecus
on_high	sublime
loftily	sublime
pass_over	transilio
leap_over	transilio
Osinius	Osinius
of_Clusium	Clusinus
mound	crepido
base	crepido
counterfeit	adsimulo
make_like	adsimulo
words	orsa
weeping	adlacrimans
immediate	instans
present	instans
Daunus	Daunus
leap	salio
the_groin	inguen
fury	fervor
Lucagus	Lucagus
four_yoked	quadriiugis
Niphaeus	Niphaeus
become_warm	intepeo
Aegaean	Aegaeon
Amyclae	Amyclae
Ausonides	Ausonides
of_Camerinum	Camers
Lucas	Lucas
Antaeus	Antaeus
fish	piscis
there	istic
roll_forward_or_along	provolvo
Dryope	Dryope
an_inhabitant_of_the_woods	silvicola
Tarquitus	Tarquitus
perhaps	fortasse
Anxur	Anxur
memorial_of_the_turning	tropaeum
stand_over	supersto
Haemonides	Haemonides
negotiation	commercium
trade	commercium
dig_down	defodio
fly_over_or_above	supervolo
quivering	tremebundus
cunning	astus
Magus	Magus
immolate	immolo
sprinkle_the_sacred_meal_upon_the_victim	immolo
bring_up_educate	educo
Eurytides	Eurytides
Clonus	Clonus
bestow	largior
give_largely	largior
stand_at	adsisto
fall_down	corruo
fall_completely	corruo
bore_or_pierce_through	perforo
piercing	penetrabilis
irrecoverable	inreparabilis
within_reach	contiguus
near	contiguus
fly_to	advolo
alight_from	desilio
leap_or_spring_down	desilio
savage	trux
going_away	abscessus
beholder	spectator

discordant_in_sound	discrepo
make_compact	addenseo
undestroyed	imperditus
destroy	interimo
terrify	perterreo
unarmed	inermus
Imaon	Imaon
hurled	missilis
the_throat	iugulum
the_joining_part	iugulum
Strymonius	Strymonius
Demodocus	Demodocus
Pheres	Pheres
Ladon	Ladon
Tyres	Tyres
Teuthras	Teuthras
intercept	intercipio
catch_thing_passing_along	intercipio
Rhoeteus	Rhoeteus
yoked_two_together	biiugis
cut	decido
Evandrian	Evandrius
of_Evander	Evandrius
unseparated	indiscretus
Thymber	Thymber
Larides	Larides
of_Daucus	Daucius
Anchemolus	Anchemolus
Sthenius	Sthenius
comrade	sodalis
Hisbo	Hisbo
recover	recepto
take_back_or_out	recepto
Lagus	Lagus
nature	natura
unmounted	pedester
pedestrian	pedester
overthrow	diruo
thicket	arbustum
grove	arbustum
growth_of_trees	arbustum
Ismar	Ismara
from_afar	eminus
Dryops	Dryops
strict	rigidus
rigid	rigidus
hard	rigidus
graze	perstringo
bind_tightly	perstringo
thigh	femur
direction	tenor
course	tenor
Maeon	Maeon
pierce_through	transverbero
beat_or_strike_through	transverbero
turn_aside	deflecto
partly	partim
pressing_on	stipatus
Cydon	Cydon
down	lanugo
soft_hair	lanugo
Pharon	Pharon
Melampus	Melampus
club	clava
cut_out	exseco
Lichas	Lichas
sew	suo
Theron	Theron
kill	occido
knock_down	occido
retreat	relabor
slip_back	relabor
support	sustento
strike	infligo
dry_ground	siccum
unhindered	inoffensus
resound	remurmuro
give_back_murmur	remurmuro
faint	langueo
trust	concredo
break	perfringo
make_sad	contristo
Sirian	Sirius
of_the_dog_star	Sirius
mournfully	lugubre
comet	cometes
crane	grus
of_the_Strymon	Strymonius
Strymonian	Strymonius
repair	reficio
paddle	subremigo
row_lightly	subremigo
stand_out	emineo
Cybele	Cybele
Phoebe	Phoebe
nightly	noctivagus
help	subsidium
murmur	murmuro
hairy	hispidus
shaggy	hispidus
Aulestes	Aulestes
Mincius	Mincius
Benacus	Benacus
500th	quingenti
500	quingenti
4_each	quaterni
Mantu	Mantua
Manto	Manto
Ocnus	Ocnus
push_forward	promoveo
move_forward	promoveo
Cycnus	Cycnus
of_the_swan	olorinus
Cupavo	Cupavo
Cinyrus	Cinyrus
Ligurian	Ligus
Graviscae	Graviscae
Pyrgi	Pyrgi
Minio	Minio
of_Caere	Caeres
of_various_colors	versicolor
Astur	Astur
Pisae	Pisae
Alphean	Alpheus
of_the_Alpheus	Alpheus
prophetic	praesagus
unexhausted	inexhaustus
300th	trecenti
300	trecenti
Ilv	Ilva
Populonia	Populonia
600th	sescenti
600	sescenti
quiver	gorytus
Cosa	Cosa
Clusium	Clusium
of_Campania	Campanus
Pactolus	Pactolus
eminent	generosus
noble	generosus
_of_noble_birth	generosus
an_arrow	calamus
reed_or_cane	calamus
Ismarus	Ismarus
kind_of_ebony	terebinthus
the_turpentine_tree	terebinthus
of_Oricus_or_Oricum	Oricius
decent	honestus
honorable	honestus
Mnestheus	Menestheus
Acmon	Acmon
Lyrnesian	Lyrnesius
of_Lyrnesus	Lyrnesius
Thaemon	Thaemon
Clarus	Clarus
Thymbris	Thymbris
Castor	Castor
of_Hicetaeon	Hicetaonius
Imbrasides	Imbrasides
Asius	Asius
enterprise	exorsum
thing_begun_or_undertaken	exorsum
become_silent	silesco
quarrel	iurgium
altercation	iurgium
adulterer	adulter
perishing	fluxus
flowing_away	fluxus
draw	obtendo
stretch_before	obtendo
bride	pacta
one_contracted_for	pacta
Venilia	Venilia
Amathus	Amathus
truly	sane
certainly	sane
untried	intentatus
fault	peccatum
Arpi	Arpi
Aetolian	Aetolus
overflow	inundo
the_Alps	Alpes
prohibition	vetitum
that_which_is_forbidden	vetitum
breathe	respiro
breathe_again	respiro
shake_off	discutio
jingling	tinnitus
unhastened	improperatus
Cretheus	Cretheus
Clytius	Clytius
ravager	vastator
sword	gladius
Lynceus	Lynceus
Prytanis	Prytanis
Noemon	Noemon
Halius	Halius
Alcander	Alcander
Halys	Halys
say_over_and_over	ingero
obtrude	ingero
heap_on	ingero
carry	ingero
Gyges	Gyges
hamstring	poples
the_hinder_part_of_the_knee	poples
Phaleris	Phaleris
uncultivated	rudis
leave_uncovered	excludo
exclude	excludo
shut_out	excludo
warrior	bellator
Inarime	Inarime
Prochyt	Prochyta
pile_together	construo
mole	pila
pier	pila
Baiae	Baiae
faithful	fidelis
fiery_dart	phalarica
heavy_spear_wound_with_combustibles	phalarica
loudly	magnum
largely	magnum
Aphidnus	Aphidnus
Erymas	Erymas
Merops	Merops
grow_warm	tepesco
lungs	pulmo
lung	pulmo
chest	stomachus
the_gullet	stomachus
lance_or_javelin	cornus
spear_shaft	cornus
cornel_cherry_tree	cornus
of_or_from_Thebes	Thebanus
Theban	Thebanus
Antiphates	Antiphates
incite	concieo
call_together	concieo
supply	praebeo
the_same_place	eodem
the_same_place	eodem
Haemon	Haemon
Tmarus	Tmarus
Aquicolus	Aquicolus
Quercens	Quercens
Athesis	Athesis
the_river_Po	Padus
Iaera	Iaera
Alcanor	Alcanor
penalty	multa
The_Kids	haedus
causing_rain	pluvialis
striking	flictus
thong_attached_the_shaft_of_javelin_or_other_missile	amentum
son_of_Aeneus_or_Aeneas	Aenides
justly	iure
rightly	iure
honored	mactus
pertaining_horses	equinus
drum	tympanum
pipe_or_flute	tibia
the_larger_of_the_shinbones	tibia
having_two_doors_or_openings	biforis
Dindyma	Dindyma
chaplet	redimiculum
something_bound_round	redimiculum
inactivity	desidia
idleness	desidia
saffron_color	crocum
saffron	crocum
bring_together	comporto
weaken	debilito
awake	invigilo
one_who_molds	fictor
Numanus	Numanus
swift_in_flight	fugax
split	diffindo
cleave_asunder	diffindo
sling	funda
Palici	Palici
of_Symaethum	Symaethius
_an_Iberian_of_the_Caucusus	Hiberus
Iberian_of_Spain	Hiberus
dusky_or_brown_tint	ferrugo
the_color_of_iron_rust	ferrugo
iron_rust	ferrugo
needle	acus
hairpin	acus
Arcens	Arcens
of_the_lungs	spiramentum
means_of_breathing	spiramentum
Themillas	Themillas
Privernus	Privernus
Idas	Idas
Promolus	Promolus
Dioxippus	Dioxippus
Clonius	Clonius
Itys	Itys
Ortygius	Ortygius
Asilas	Asilas
Liger	Liger
Emathion	Emathion
Lucetius	Lucetius
piece_broken_off	fragmen
fracture	fragmen
pleasantness	lepor
without_glory	inglorius
Licymnia	Licymnia
Helenor	Helenor
run_through	transfodio
dig_through	transfodio
consume	adedo
capture	expugno
assault	expugno
Calliope	Calliope
_gifts_thrown_crowd	missile
projectile	missile
missile	missile
open	interluceo
give_light_through	interluceo
Actor	Actor
numb	torpeo
hastening	festinus
that_which_makes_known	nuntius
announcing	nuntius
winged	pennatus
very_much	nimis
Numa	Numa
dwell_near_or_by	accolo
stab	confodio
whirl_about	roto
move_like_wheel	roto
push	proturbo
vexed	gravor
burdened	gravor
rain	pluvia
become_faint	languesco
cut	succido
cut_beneath	succido
sink_down	recumbo
lie_down_again	recumbo
drive_through	transadigo
Tagus	Tagus
gasp	singultus
Sulmo	Sulmo
cupola	tholus
Hyrtacus	Hyrtacus
Latonian	Latonius
of_Latona	Latonius
much_entangled	perplexus
not_seeing_or_knowing_beforehand	imprudens
parting	divortium
separation	divortium
lurid	sublustris
faintly_gleaming	sublustris
Volcens	Volcens
armed_with_shield	scutatus
Caedicus	Caedicus
distant	absens
absent	absens
Remulus	Remulus
of_Tibur	Tiburs
boss	bulla
amulet	bulla
locket	bulla
bubble	bulla
complete	perfectus
excessive	nimius
Abaris	Abaris
Rhoetus	Rhoetus
Herbesus	Herbesus
Fadus	Fadus
common_people	plebs
rave	perfuro
rage_wildly	perfuro
mute	mutus
inarticulate	mutus
insane	vesanus
unfed	impastus
Lamus	Lamus
Lamyrus	Lamyrus

make_tepid_or_warm	tepefacio
sob	singulto
rashly	temere
breathe_forth_noisily	proflo
blow	proflo
Rhamnes	Rhamnes
pluck_asunder	discerpo
foremost	primoris
first	primoris
exchange	permuto
Lycaon	Lycaon
weep	inlacrimo
not_saluted	insalutatus
dissimilar	dissimilis
6th	sex
6	sex
red	rubeo
Arisba	Arisba
conquer_completely	devinco
immediately	actutum
promptly	actutum
destroy	deleo
leading_two_ways	bivius
immediately	confestim
pursue	persequor
sacrifices/rites_in_honor_of_the_dead	inferiae
buy	emo
free_from_roughness	erudio
train	erudio
instruct	erudio
Opheltes	Opheltes
pertaining_Pallanteum	Pallanteus
summon	accio
unshorn	intonsus
unshaven	intonsus
on_guard	excubo
lie_out	excubo
without_sleep	insomnis
adorn_with_various_colors	vario
diversify	vario
vary	vario
100_each	centeni
set_before	obsido
refresh	procuro
attend_to	procuro
care_for	procuro
get_ready	apparo
injure	pecco
commit_wrong	pecco
fertile	fertilis
productive	fertilis
in_view_of	prae
in_the_face_of	prae
before	prae
plunge	demergo
dip	demergo
shine_against	offulgeo
pitch	pix
Galatea	Galatea
Doto	Doto
Nereian	Nereius
of_Nereus	Nereius
heavens	mundus
universe	mundus
world	mundus
disquieted	anxius
troubled	anxius
shape	formo
form	formo
lasting_throughout_the_year	perennis
protection	praesentia
presence	praesentia
fortification	vallum
fired	ignesco
take_fire	ignesco
bleating	balatus
endure	perpetior
bear_the_end	perpetior
an_opening	caulae
sheepcote	ovile
ambush	insidior
swing_or_hurl	attorqueo
Ganges	Ganges
soothe	sedo
Etruscan	Lydus
Lydian	Lydus
dwelling_on_the_Palatine_hill	Palatinus
belonging_to	Palatinus
Thaumantias	Thaumantias
Pilumnus	Pilumnus
Araxes	Araxes
Dahae	Dahae
two_horned	bicornis
Rhine	Rhenus
people_of_Belgic_Gaul	Morinus
of_or_from_the_Morini	Morinus
Euphrates	Euphrates
Gelonian_or_Scythian	Gelonus
arrow_bearing	sagittifer
of_Cariin_the_southwestern_part_of_AsiMinor	Car
Carian	Car
Leleges	Leleges
an_inhabitant_of_Africa	Afer
African	Afer
Mulciber	Mulciber
ungird	discingo
examine	recognosco
Iapyx	Iapyx
Arab	Arabs
Anubis	Anubis
barker	latrator
one_who_barks_like_dog	latrator
of_every_kind	omnigenus
of_all_sorts	omnigenus
metallic_rattle	sistrum
Egyptian	Aegyptius
Bactra	Bactra
Egypt	Aegyptos
red	ruber
Antonius	Antonius
beaked	rostratus
Agrippa	Agrippa
overhanging	minax
projecting	minax
Catilina	Catilina
chariot	pilentum
beat_out	extundo
Luperci	Luperci
Gallic_javelin	gaesum
milky	lacteus
soldier's_cloak	sagulum
made_of_twigs	virgatus
goose	anser
_silver	argenteus
stalk	culmus
Manlius	Manlius
Cloelia	Cloelia
Cocles	Cocles
bridge	pons
Porsenn	Porsenna
thorn	vepres
Mettus	Mettus
sow	porca
pig	porca
Tatius	Tatius
Romans	Romulidae
descendants_or_people_of_Romulus	Romulidae
games_in_the_Circus	circensis
not_afraid	impavidus
texture	textum
that_which_is_woven_or_plaited	textum
that_can_expressed	enarrabilis
become_glowing	inardesco
take_fire	inardesco
fatal	fatifer
separate	secerno
tepid	egelidus
lukewarm	egelidus
Silvanus	Silvanus
Caere	Caere
hoof	ungula
foul_smelling	putris
fetid	putris
going_on_four_feet	quadrupedans
dusty	pulvereus
cavalry	equitatus
wound	vulnero
who_or_what_you_please	quivis
deprive	viduo
Erulus	Erulus
unsatisfied	inexpletus
double	duplico
fold_over	duplico
shine_or_glitter_at_the_end	praefulgeo
an_announcement	nuntium
yesterday's	hesternus
of_yesterday	hesternus
surely	profecto
gleam	rutilo
redden	rutilo
dry	sudus
unexpectedly	improviso
military_service	militia
frost	gelu
Tarcho	Tarcho
fasten	subiungo
join_under_or_to	subiungo
Maeonia	Maeonia
diviner	haruspex
an_inspector_of_entrails	haruspex
present	praesum
before	praesum
Tuscany	Etruria
Etruria	Etruria
surround	circumsisto
kill	neco
torture	tormentum
dead	mortuus
Tuscan	Etruscus
Etrurian	Etruscus
raise_din_around	circumsono
sound_about	circumsono
Etruscan	Tuscus
Tuscan	Tuscus
Etrurian	Tuscus
saved	sospes
allowed	licitus
go_before	praecedo
bend_back	retorqueo
twist_back	retorqueo
panther	panthera
bind	subligo
bind_under	subligo
tunic	tunica
morning	matutinus
of_or_belonging_the_morning	matutinus
Lemnius	Lemnius
lump	massa
pair_of_tongs	forceps
the_bellows	follis
pair_of_bellows	follis
melt	liquesco
become_fluid_or_liquid	liquesco
steel	chalybs
wound_making	vulnificus
mistress	magistra
cut_off	deseco
fasten_together	conecto
fear_bringing	horrifer
red_and_gold	rutilus
unfinished	imperfectus
smooth	polio
mold	informo
impart_form_to	informo
Pyracmon	Pyracmon
Steropes	Steropes
Brontes	Brontes
pertaining_Vulcan	Vulcanius
Chalybes	Chalybes
mass_or_bar_of_hot_iron	strictura
Lipare_or_Lipar	Lipare
skillfully_made	fabrilis
having_power_over_fire	ignipotens
allotment	pensum
wool	pensum
endure	tolero
career	curriculum
drive_off_or_away_from	abigo
doubt	indubito
mixed_metal_of_the_color_of_amber	electrum
amber	electrum
bind	devincio
bind_fast	devincio
of_Tithonus	Tithonius
born	natus
Laurentes	Laurentes
Carinae	Carinae
neat	lautus
washed	lautus
Ianiculum	Ianiculum
town	oppidum
the_goatskin_shield_of_Jupiter_or_Minerva	aegis
pastoral	silvestris
pertaining_the_woods	silvestris
Capitoline	Tarpeius
Tarpeian	Tarpeius
Argiletum	Argiletum
Lycaean	Lycaeus
of_Lycaeus	Lycaeus
Pan	Pan
of_Parrhasia	Parrhasius
Lupercal	Lupercal
of_Carmentis	Carmentalis
Carmentis	Carmentis
Albula	Albula
of_debased_color	decolor
worse	deterior
unteachable	indocilis
born_in_the_land	indigena
founder	conditor
throw_to	adicio
Lernaean	Lernaeus
of_Lerna	Lernaeus
Typhoeus_or_Typhon	Typhoeus
Nemea	Nemea
Pholus	Pholus
Hylaeus	Hylaeus
having_two_types_of_limbs	bimembris
Eurystheus	Eurystheus
Oechali	Oechalia
Salii	Salii
charger	lanx
broad_dish_or_plate	lanx
declining	devexus
cup	scyphus
wreath_of_poplar	populus
poplar_tree	populus
of_Pinarius	Pinarius
Potitius	Potitius
half_wild	semifer
dead_body	cadaver
pillage	rapina
plundering	rapina
robbery	rapina
swear_off	abiuro
drag_away	abstraho
squeeze	ango
smoky	fumifer
vomit_out_or_up	evomo

millstone	molaris
uncover	detego
spring_back_or_apart	dissulto
leap_asunder	dissulto
impulse	impulsus
an_impelling	impulsus
convenient	opportunus
suitable	opportunus
abrupt	praecisus
rocky	saxeus
barrier	obex
an_obstacle	obex
make_strong	emunio
fortify	emunio
gall	fel
the_gall_bladder	fel
guard	custodio
departure	abitus
young	iuvencus
untried	intractatus
untouched	intractatus
at_length	aliquando
at_some_time	aliquando
reek	tepeo
moderately_warm	tepeo
Cacus	Cacus
half_man	semihomo
recess	recessus
superstition	superstitio
religious_awe	superstitio
expiatory	lustralis
hairy	villosus
shaggy	villosus
interweave	intertexo
Pheneos	Pheneos
desirous	cupidus
Arcadia	Arcadia
Salamis	Salamis
Hesione	Hesione
proved	spectatus
tested	spectatus
below	infra
wash_against	adluo
pertaining_Daunus	Daunius
contract_for	pango
agree_upon	pango
settle_for	pango
fix	pango
fasten	pango
approach	temptamentum
experiment	temptamentum
essay	temptamentum
trial	temptamentum
envoy	legatus
lieutenant	legatus
Cyllene	Cyllene
Atlantis	Atlantis
Electra	Electra
afraid	extimesco
cling_to	inhaereo
stick_to	inhaereo
peace_bringing	pacifer
Hercules	Amphitryoniades
son_of_Amphitruo	Amphitryoniades
the_act_of_bending_or_curling	flexus
wave	flexus
curl	flexus
oiled	unctus
anointed	unctus
toil	luctamen
striving	luctamen
ripe	mitis
mild	mitis
flow_back	refluo
lie_stretched_out	procubo
of_the_same_color	concolor
horned	corniger
detriment	incommodum
plowed_fields	culta
Pallanteum	Pallanteum
Euander	Evander
Pallas	Pallas
Arcas	Arcas
of_the_mind	tumor
swelling	tumor
carry	reveho
dark	umbrosus
shady	umbrosus
flit_around	pervolito
fly_about	pervolito
flash	radio
emit_rays_of_light	radio
reflect	repercutio
strike_back	repercutio
bowl	labrum
vat_or_tub	labrum
in_as_much_as	sicut
just_as	sicut
spread_abroad	increbresco
increase_more_and_more	increbresco
become_frequent	increbresco
Venulus	Venulus
worshipper	cultor
husbandman	cultor
conspire	coniuro
swear_together	coniuro
bind_together	internecto
gaze_at	prospecto
look_forth_upon	prospecto
look_forth	prospecto
workbasket	calathus
wicker_basket	calathus
distaff	colus
Camilla	Camilla
of_or_from_the_Volscians	Volscus
Volscian	Volscus
Satura	Satura
Feronia	Feronia
of_Anxur	Anxurus
of_or_from_the_Labici	Labicus
Sacranus	Sacranus
ancestors	veteres
the_ancients	veteres
close_up	denseo
thicken	denseo
make_thick	denseo
armed_with_shield	clipeatus
Argus	Argus
argument	argumentum
evidence	argumentum
proof	argumentum
plant_upon_or_over	obsero
adorn	insignio
decorate_with_mark	insignio
Io	Io
grow_fierce	crudesco
become_harsh	crudesco
blow_or_breathe_out	efflo
of_the_sea	marinus
send_away	relego
Phoebigena	Phoebigena
the_healing_art	medicina
inventor	repertor
discoverer	repertor
Paeonius	Paeonius
tear_pieces	distraho
pull_apart	distraho
stepmother	noverca
appeasable	placabilis
Egeria	Egeria
Arici	Aricia
Virbius	Virbius
Hippolytus	Hippolytus
Fucinus	Fucinus
made_of_glass	vitreus
glassy	vitreus
Anguitia	Anguitia
Marsian	Marsus
sleep_bringing	somnifer
able	evalesco
grow_strong	evalesco
Umbro	Umbro
shot	missus
sending_away	missus
Archippus	Archippus
of_Marruvium	Marruvius
Aequian	Aequiculus
of_the_Aequi	Aequiculus
hunting	venatus
Ufens	Ufens
Nersae	Nersae
mountainous	montosus
the_cork_tree	suber
slender_javelin	cateia
form	ritus
farm_of_religious_ceremonial	ritus
Teutonic	Teutonicus
of_the_Teutons	Teutonicus
Abella	Abella
fruit_producing	malifer
Celemna	Celemna
Batulum	Batulum
Rufrae	Rufrae
Sarnus	Sarnus
Sarrastes	Sarrastes
Capreae	Capreae
Teleboae	Teleboae
Sebethis	Sebethis
Telon	Telon
Oebalus	Oebalus
unmentioned	indictus
crooked	falcatus
hooked	falcatus
short_Spanish_shield	caetra
dart_with_thong_on_its_shaft	aclys
Oscan	Oscus
Saticulus	Saticulus
Vulturnus	Vulturnus
neighbor	accola
shallow	vadosus
Cales	Cales
pertaining_Sidicini	Sidicinus
heavy_pronged_hoe	rastrum
of_Mount_Massicus	Massicus
Halaesus	Halaesus
Hermus	Hermus
the_beard_of_wheat	arista
Allia	Allia
of_Ort	Ortinus
Nursia	Nursia
Fabaris	Fabaris
the_Tiber_river	Tiberis
Himella	Himella
of_or_from_Foruli	Forulus
Casperia	Casperia
Severus	Severus
Tetrica	Tetrica
of_Rosea	Roseus
Mutusc	Mutusca
olive_bearing	olivifer
Eretum	Eretum
ancient_Sabines	Quirites
of_Amiternum	Amiternus
tribe	tribus
pertaining_the_Claudii	Claudius
Clausus	Clausus
of_town_named_'Asia'	Asius
of_Asia	Asius
food	pastus
fodder	pastus
pasture	pastus
of_Capena	Capenus
Ciminus	Ciminus
of_Flavinium_or_Flavina	Flavinius
Soracte	Soracte
Falisci	Falisci
of_or_from_the_Aequi	Aequus
Fescennine	Fescenninus
of_Fescennia	Fescenninus
gripe_or_grasp_again	retracto
handle_again	retracto
Messapus	Messapus
boot_or_high_shoe_made_of_rawhide	pero
cap_made_of_skin	galerus
bluish	liveo
leaden_ball_or_bullet	glans
an_acorn	glans
Amasenus_river	Amasenus
Anagnia	Anagnia
of_the_Hernici	Hernicus
Anio	Anio
Praeneste	Praeneste
legion	legio
Caeculus	Caeculus
founder	fundator
of_Praeneste	Praenestinus
Othrys	Othrys
Homole	Homole
name_of_the_Centaurs	nubigenae
the_cloud_born	nubigenae
Coras	Coras
Catillus	Catillus
Tiburtus	Tiburtus
of_Tibur	Tiburtinus
untrimmed	impexus
uncombed	impexus
of_the_Sabelli_or_Sabines	Sabellus
pike	dolo
staff_or_pole_with_an_iron_point	dolo
javelin	pilum
Spanish	Hiberus
Iberian	Hiberus
of_or_from_Iberia	Hiberus
Tirynthian	Tirynthius
of_Tiryns	Tirynthius
Geryon	Geryon
Laurentian	Laurentius
of_Laurentum	Laurentius
woman	mulier
Rhea	Rhea
Aventinus	Aventinus
of_Agyll	Agyllinus
conqueror	debellator
Lausus	Lausus
Mezentius	Mezentius
despiser	contemptor
Helicon	Helicon
square_tablet_or_piece	tessera
the_trumpet	classicum
the_sound_of_the_trumpet	classicum
forge	fornax
furnace	fornax
recast	recoquo
boil_again	recoquo
plowshare	vomer
covering_made_of_metal_for_the_protection_of_the_leg	ocrea
greave	ocrea
corselet	thorax
wicker_work	crates
hurdle	crates
made_of_willow	salignus
Antemnae	Antemnae
tower_crowned	turriger
of_or_from_Crustumeri	Crustumerus
Tibur	Tibur
Atina	Atina
an_anvil	incus
whetstone	cos
grease	arvina
clean	tergeo
wipe	tergeo
quiet	inexcitus
dormant	inexcitus
blow	conspiro
answering_sound	adsensus
an_assenting	adsensus
open	resero
unbolt	resero
of_Gabii	Gabinus
lever	vectis
Parthian	Parthus
Arabian	Arabus
Arab	Arabus
Getae	Getae
sacrilegious	sacrilegus
guilty_of_impiety	sacrilegus
will	nutus
nod	nutus
seaweed	alga
throw_down	perverto
overthrow	perverto
overturn	perverto
wild_dance	thiasus
dance_in_honor_of_Bacchus	thiasus
mingle_with	admisceo
conjure	obtestor
call_witness	obtestor
pest_bringing	pestifer

breathing_place	spiraculum
cave	specus
roaring	fragosus
crashing	fragosus
on_or_from_either_side	utrimque
Ampsanctus	Ampsanctus
famous	nobilis
illustrious	nobilis
without_restraint	licenter
freely	licenter
hand_hand	comminus
enough	abunde
sufficiently	abunde
besprinkle	respergo
sprinkle_over	respergo
since_indeed	quandoquidem
friendship	amicitia
stain	imbuo
wet	imbuo
permeate	imbuo
drench	imbuo
bleat	balo
5th	quinque
5	quinque
Galaesus	Galaesus
Almo	Almo
cloud	nubilum
darkness	nubilum
burn_at_the_point	praeuro
palisade	sudes
stake	sudes
trumpet	bucina
Venilus	Velinus
Nar	Nar
sulphureous	sulphureus
tremble	contremo
curving_back_or_round	recurvus
pertaining_shepherds	pastoralis
meet	nanciscor
obtain	nanciscor
wildly	immane
split_in_four_parts	quadrifidus
burnt	obustus
brand	torris
firebrand	torris
the_groin	ile

set_on_fire_from_beneath	succendo
distinguished	eximius
exceptional	eximius
green	virido
pertaining_an_owner	erilis
comb	pecto
decorate	orno
equip	orno
Silvia	Silvia
Tyrrheus	Tyrrheus
nourish	nutrio
the_sons_of_Tyrrheus	Tyrrhidae
of_Cocytus	Cocytius
encourage	exhortor
abound	exubero
supply	suggero
bring_or_put_under_or_up_to	suggero
of_twigs	virgeus
noise	sonor
flaming	flammeus
fiery	flammeus
hiss	sibilo
openly	palam
dowry	dos
endowment	dos
gift	dos
old_woman	anus
Calybe	Calybe
wrinkle	ruga
change_the_form	transformo
Arde	Ardea
Danae	Danae
pertaining_Acrisione_or_Danae	Acrisioneus
dusky	fuscus
dark	fuscus
of_the_hair	crinalis
hurrah_oh	io
endure	sustineo
able_to	sustineo
sustain	sustineo
gird_on	incingo
staff_wreathed_with_ivy_and_vine_leaves	thyrsus
the_stalk_of_plant	thyrsus
and_indeed	etenim
woo	euhoe
fly_away	evolo
lashing	plaga
wound	plaga
blow	plaga

the_box_tree	buxus
spinning	volubilis
turning	volubilis

craze	lympho
dilute_with_water	lympho
raging	furialis
Acrisius	Acrisius
Inachus	Inachus
situated_apart	dissideo
free	liber
Lacedaemon	Lacedaemon
robber	praedo
greatly	multa
much	multa
having_been_accustomed	solitus
take_in	percipio
winding	tortilis
twisted	tortilis
touch	attactus
touching	attactus
place_or_fasten_under	subdo
put_under	subdo
cook	coquo
Amata	Amata
Gorgonian	Gorgoneus
go_about	ambio
go_round	ambio
work	opera
make_pointed	acuo
sprout	pullulo
spring_out	pullulo
Plu	Pluto
Allecto	Allecto
grief_inducing	luctificus
deadly	funestus
with_young	praegnans
Cisseis	Cisseis
Roman_goddess_of_war	Bellona
Bellona	Bellona
endow	doto
commodity	merces
article_for_sale	merces
wages	merces
pay	merces
unattempted	inausus
Calydon	Calydon
destroy	perdo
satisfy	exsaturo
Phryx	Phryx
it_concerns	refert
Inachian	Inachius
of_Inachus	Inachius
produce	creo
create	creo
illegitimate	nothus
cunningly_wrought	daedalus
skillful	daedalus
artificial	daedalus
tapestry	tapetum
wing_footed	alipes
select	eligo
pick_out	eligo
divine	auguro
shudder_at	exhorresco
shudder_greatly	exhorresco
wealth	opulentia
unmoved	immobilis
tiara	tiara
turban	tiara
headband	tiara
decay	abolesco
bringing_disgrace	indecor
disgraceful	indecor
harmless	innocuus
washing_away	diluvium
performance	actus
an_impelling	actus
thronging	effusus
overflowing	effusus
poured_forth	effusus
Samothracia	Samothracia
Phrygia	Phrygia
of_Aurunca	Auruncus
Auruncan	Auruncus
small_figure_of_eight_shield	ancile
togof_purple_cloth	trabea
pertaining_Quirinus_or_Romulus	Quirinalis
double_faced	bifrons
two_faced	bifrons
Ianus	Ianus
vine_planter	vitisator
Sabine	Sabinus
Italus	Italus
court	curia
Roman_senate	curia
place_of_assembly	curia
ancestral	avitus
of_grandfather	avitus
ride_before	praevehor
train	domito
tame	domito
youthful	primaevus
eldest	primaevus
wing	pinna
feather	pinna
ditch	fossa
holy	augustus
speaker	orator
begotten_of	satus
Numicus	Numicus
spread_abroad	dido
invoke	invoco
call_upon	invoco
sport	adludo
speak_playfully	adludo
one_of_the_equal_quarters_of_wheaten_loaf_or_cake	quadra
anything_quadriform	quadra
wide	patulus
opening	patulus
crust	crustum
want	penuria
fruit	pomum
cake	libum
of_fine_wheat	adoreus
bind_fast	religo
tie_up	religo
return	recurro
run_back	recurro
supported	effultus
propped_up	effultus
sacrificial_animal	bidens
having_two_teeth	bidens
conversation	colloquium
poisonous	mephitis
Albunea	Albunea
prophetic	fatidicus
smoking	fumidus
swarm	examen
multitude	examen
interchangeable	examen	mutuus
fear	terror
an_omen	portentum
connect	adiungo
join_to	adiungo
palace	regia
grandfather	atavus
Turnus	Turnus
marriageable	nubilis
Picus	Picus
Marica	Marica
Faunus	Faunus
position	status
Erato	Erato
an_oar	tonsa
yellowish	luteus
blazing	fervidus
intensely_hot	fervidus
except	praeter
beyond	praeter
past	praeter
so_as_pass_by	praeter
bear	ursus
bristle_bearing	saetiger
clever	argutus
clear	argutus
cedar	cedrus
daughter	filia
perilous_approached	inaccessus
difficult_of_approach	inaccessus
of_Circe	Circaeus
trembling	tremulus
shine	splendeo
funeral_rites	exsequiae
of_Aeneas	Aeneius
direct	rectus
straight	rectus
Caieta	Caieta
made_of_horn	corneus
Latinus	Latinus
perform_	fungor
place_heap_on_heap	accumulo
the_shoulder	armus
spur	calcar
dig	fodio
Romulean	Romulus
of_Romulus	Romulus
offspring	propago
the_layer_of_vine	propago
that_which_is_fastened_forward_or_along	propago
around	circa
rebellious	rebellis
warring	rebellis
Gaul	Gallus
Marcellus	Marcellus
passage	meatus
going	meatus
sweetly	molliter
gently	molliter
softly	molliter
mollius	molliter

restore	restituo
Maximus	Maximus
Fabius	Fabius
Serranus	Serranus
Fabricius	Fabricius
small_estate	parvum
one_of_the_Scipios	Scipiades
Gracchus	Gracchus
Cossus	Cossus
Ca	Cato
defile	temero
desecrate	temero
violate	temero
Corinth	Corinthus
the_Capitol	Capitolium
triumph	triumpho
grow_accustomed_to	assuesco
Monoecus	Monoecus
Camillus	Camillus
Torquatus	Torquatus
Drusus	Drusus
Decii	Decii
at_any_rate	utcumque
at_any_event	utcumque
whenever	utcumque
according_as	utcumque
however	utcumque
in_whatever_way	utcumque
freedom	libertas
consul	consul
burden	fascis
bundle	fascis
Brutus	Brutus
Tarquinius	Tarquinius
public	popularis
Ancus	Ancus
arrogant	iactans
Tullus	Tullus
Cures	Cures
covered_over_with_gray	incanus
Nys	Nysa
Dionysus	Liber
Bacchus	Liber
covered_in_vines	pampineus
quiet	paco
render_peaceful	paco
even_though	licet
bronze_footed	aeripes
Nilus	Nilus
sevenfold	septemgeminus
pertaining_the_Maetoae	Maeotius
Caspian	Caspius
of_the_Caspian_Sea	Caspius
heaven_bearing	caelifer
bring_forth	profero
native_american	Indus
Indian	Indus
belonging_India	Indus
Saturnus	Saturnus
Augustus	Augustus
Berecyntius	Berecyntius
Cor
Bola	Bola
another_name_for_god_Pan	Inuus
Castrum_Inui	Castrum
of_or_from_the_Pometii	Pometius
of_Collatia	Collatinus
Fidena	Fidena
Gabii	Gabii
Nomentum	Nomentum
of_citizen	civilis
Numitor	Numitor
Procas	Proca
Lavinia	Lavinia
Silvius	Silvius
bright	illustris
assembly	conventus
lacking_guile	simplex
naïve	simplex
artless	simplex
from_that_place	exinde
wash_out_or_away	eluo
grow_into	inolesco
bodily	corporeus
utterly	funditus
completely	funditus
see_distinctly	dispicio
earthen	terrenus
hurtful	noxius
guilty	noxius
vigor	vigor
activity	vigor
liveliness	vigor

drink	poto
oblivion	oblivium
murmur	strepo
make_noise	strepo
lily	lilium
countless	innumerus

swim_in_front_of_or_by	praenato
sequestered	seclusus
moisten	rigo
distinguish_by_number	dinumero
reckon	recenseo
estimate_from_the_beginning	recenseo

till_again	recolo
dwell	incolo
inhabit	incolo
meadow	pratum
rise_above	exsto
stand_forth_or_out	exsto
Musaeus	Musaeus
refine	excolo
cultivate_completely	excolo
Eridanus	Eridanus
from_above	superne
sweet_smelling	odoratus
originally_Paean	Paean
of_ivory	eburneus
scallop	pecten
shell_fish	pecten
comb	pecten
speak_against	obloquor
circling_dance	chorea
clothe	vestio
lawn_or_meadow	virectum
green_or_grassy_spot	virectum
brothel	fornix
vault	fornix
an_arch	fornix
run_through_or_over	percurro
Phlegyas	Phlegyas
draw	distringo
draw_apart	distringo
adultery	adulterium
wealth	divitia
riches	divitia
dependent	cliens
client	cliens
rise	exsurgo
rise_up	exsurgo
lie_near_or_by	accubo
royal	regificus
magnificent	regificus
support	fulcrum
genial	genialis
sacred_the_guardian_spirit	genialis
similar_to	adsimilis
like	adsimilis
Ixion	Ixion
Lapitha	Lapitha
grow_again	renascor
reproduced	renascor
born_again	renascor
fiber	fibra
force_open_in_cracks	rimor
bringing_forth	fecundus
the_liver	iecur
immortal	immortalis
hooked	obuncus
vulture	vultur
stretch_forth	porrigo
Roman_acre	iugerum
foster_son	alumnus
all_producing	omniparens
Tityos	Tityos
smoky	fumeus
tramp	pulsus
striking_or_beating	pulsus
horn_hoofed	cornipes
that_can_imitated	imitabilis
imitate	imitor
Salmoneus	Salmoneus
cancel	rescindo
tear_off_or_away	rescindo
the_stepsons_of_Aloeus	Aloidae
of_Titanian_origin	Titanius
Titanian	Titanius
distance_upward	suspectus
upward_views	suspectus
looking_up	suspectus
snake	hydra
water_serpent	hydra
prisoner	custodia
protection	custodia
custody	custodia
causing_fearful_sound	horrisonus
guilty	sons
hurtful	sons
differ	differo
divulge	differo
scatter	differo
Rhadamanthus	Rhadamanthus
fetter	catena
chain	catena
sleepless	exsomnis
Tisiphone	Tisiphone
that_which_cannot_overcome	adamas
of_the_Elysian_fields	Elysius
Elysian	Elysius
split_apart	findo
yoke_or_team_of_four_horses	quadrigae
an_instigator	hortator
one_giving_encouragement_or_inciting	hortator
move_away	amoveo
lead_around	circumduco
crying_Euhan_shrieking_madly	euhans
foot_soldier	pedes
slaughter	strages
nostril	naris
ignominious	inhonestus
dishonorable	inhonestus
barbarously	crudeliter
cruelly	crudeliter
lacerate	lanio
yawn	hio
frustrate	frustror
render_vain	frustror
move	confero
transfer	confero
collect	confero
Idaeus	Idaeus
Polyboetes	Polyboetes
Antenorides	Antenorides
Thersilochus	Thersilochus
Medon	Medon
doomed	caducus
liable_fall	caducus
Adrastus	Adrastus
Parthenopaeus	Parthenopaeus
Tydeus	Tydeus
crowd_together	frequento
former	pristinus
shady	umbrifer
of_Marpesus	Marpesius
departure	discessus
able	queo
rugged	sentus
thorny	sentus
shape	figura
form	figura
Caeneus	Caeneus
Laodamia	Laodamia
Evadne	Evadne
Eriphyl	Eriphyla
Procris	Procris
Phaedra	Phaedra
of_myrtle	myrteus
consume	peredo
eat_up	peredo
eat_through_or_completely	peredo
melting	tabes
control	coerceo
enclose	coerceo
9_times	noviens
unlovely	inamabilis
poverty	pauperies
narrow_or_straitened_circumstances	pauperies
hate	perodi
Minos	Minos
investigation	quaesitor
an_investigator	quaesitor
juror	iudex
judge	iudex
an_infant	infans
not_capable_of_speech	infans
wailing	vagitus
throat	guttur
windpipe	guttur
mouthful	offa
dye	medico
medicate	medico
treat	medico
three_throated	trifaux
triple_voiced	trifaux
Cerberus	Cerberus
abandon	expono
sea_green	glaucus
dark	glaucus
slime	limus
mud	limus
leaky	rimosus
full_of_cracks	rimosus
stitched_together	sutilis
cavity	alveus
deserving_of_respect	venerabilis
venerable	venerabilis
uncle	patruus
bark	latro
eternally	aeternum
continually	aeternum
door_keeper	ianitor
Amphrysius	Amphrysius
attempt	adorior
attack	adorior
Pirithous	Pirithous
convey	vecto
drowsy	soporus
from_over_there	istinc
complain_loudly_about	increpo
rattle	increpo
little_while	parumper
not_commanded	iniussus
serious	severus
mother	creatrix
she_who_brings_forth	creatrix
Velian	Velinus
of_Velia	Velinus
unconquered	invictus
agreeable	iucundus
delightful	iucundus
pleasant	iucundus
savage	violentus
violent	violentus
deceive	deludo
stormy	ventosus
windy	ventosus
Leucaspis	Leucaspis
admit	admitto
send_to	admitto
carry_across_or_over	transporto
envious	lividus
bluish	lividus
remove	summoveo
move_from_beneath	summoveo
fall	autumnus
rowboat	cumba
small_boat	cumba
carry_up_often	subvecto
rust_colored	ferrugineus
sordid	sordidus
dirty	sordidus
hoariness	canities
Charon	Charon
foulness	squalor
ferryman	portitor
carrier	portitor
fret	aestuo
seethe	aestuo
burn	aestuo
very_hot	aestuo
chasm	vorago
dirt	caenum
Tartarean	Tartareus
pertaining_Tartarus	Tartareus
skilled	doctus
learned	doctus
taught	doctus
three_bodied	tricorpor
fearfully	horrendum
Lerna	Lerna
beast	belua
Briareus	Briareus
hundredfold	centumgeminus
stay	stabulo
in_stall_or_standing_place	stabulo
an_elm_tree	ulmus
viperous	vipereus
dissention	discordia
disagreement	discordia
deadly	mortifer
want	egestas
need	egestas
poverty	egestas
crime_inducing	malesuadus
desperate	malesuadus
disease	morbus
sickness	morbus
dip	mergo
Phlegethon	Phlegethon
timid	timidus
cowardly	timidus
hesitant	timidus
need	opus
no_sacred	profanus
profane	profanus
outside_the_shrine	profanus
pour_over_or_upon	superfundo
begin	incoho
lay_the_foundation	incoho
knife	culter
plowshare	culter
sacrifice	libamen
libation	libamen
stiff_hair	saeta
bristle	saeta
turn_into	invergo
cause_incline	invergo
bird	volans
winged_creature	volans
consisting_of_jagged_stone	scrupeus
throat	hiatus
gaping	hiatus
quick	properus
pass_around	circumfero
bear_round	circumfero
Corynaeus	Corynaeus
absorbent	bibulus
drinking_readily	bibulus
oil	olivum
of_frankincense	tureus
burn	cremo
ministry	ministerium
service	ministerium
bier	feretrum
weep_over	defleo
weep_much	defleo
hot	calidus
warm	calidus
adorn	decoro
the_end	supremum
break_off	refringo
break_back	refringo
gold_foil	bractea
thin_plate_of_metal	bractea
plant	semino
green	vireo
the_mistletoe	viscum
wintry	brumalis
of_different_color	discolor
perch	sido
seat_one’s_self	sido
aromatic	olens
having_smell	olens
go	prodeo
shade	opaco
truly	vere
roll_to	advolvo
easily_split	fissilis
pertaining_the_ash_tree	fraxineus
smite	ico
the_pine	picea
the_pitch_pine	picea
foaming	spumosus
cockle_shell	concha
shellfish	concha
lower	inferior
wind_instrument	lituus
an_augur's_staff	lituus
son_or_descendant_of_Aeolus	Aeolides
inhume	humo
lay_earth_on_anything	humo
interweave	sero
join_together	sero
result	eventus
Styx	Styx
decision	consultum
decree	consultum
defile	incesto
trace	vestigo
track	vestigo
metal	metallum
mine	metallum
put_forth_leaves	frondesco
crop	decerpo
pluck_off	decerpo
golden_haired	auricomus
partitive	opertum
covered_or_secret_place	opertum
valley	convallis
valley_completely_enclosed_by_hills	convallis
swim_upon_or_over	inno
surround	circumvenio
Cocytus	Cocytus
carry_up	eveho
carry_forth	eveho
descent	descensus
going_down	descensus
Theseus	Theseus
buy_out_of_slavery	redimo
purchase	redimo
buy_back	redimo
Pollux	Pollux
harmonious	canorus
lute_string	fides
Orpheus	Orpheus
put_in_charge	praeficio
marsh	palus
advise	praecipio
anticipate	praecipio
spur	stimulus
prick	stimulus
resound	remugio
bellow_again_or_loudly	remugio
venturing	audens
complete	defungor
finish	defungor
raging	rabidus
mad	rabidus
savage	rabidus
raving	rabidus
by_so_much	tanto
mockery	ludibrium
mocking	ludibrium
educate	instituo
equip	instituo
undertake	instituo
not_due	indebitus
prescient	praescius
foreknowing	praescius
survey	obeo
visit	obeo
go_to	obeo
adorn	como
arrange	como
flock	grex
herd	grex
_the_seats_for_the_audience	spectaculum
spectacle	spectaculum
Deiphobe	Deiphobe
read_through	perlego
mold_out	effingo
Icarus	Icarus
string	filum
thread	filum
that_cannot_disengaged_or_disentangled	inextricabilis
in	insum
Minotaurus	Minotaurus
two_formed	biformis
Pasiphae	Pasiphae
substitute	suppo
put_something_in_the_place_of_another	suppo
put	suppo
urn	urna
the_Athenians	Cecropides

son_or_descendant_of_Cecrops	Cecropides
have_weight_of	pendo
weigh	pendo
Chalcidian	Chalcidicus
of_Chalcis	Chalcidicus
Arctos	Arctos
swim_out_or_away	eno
unaccustomed	insuetus
pertaining_Minos	Minoius
Daedalus	Daedalus
an_epithet_of_Hecate_or_Diana	Trivia
Trivia	Trivia
secret	secretum
solitary_place	secretum
anything_apart	secretum
push_or_thrust_off	abstrudo
seed	semen
Cumae	Cumae
Euboean	Euboicus
of_Euboe	Euboicus
float	fluito
Sirenes	Sirenes
unexpected	inopinus
drug	soporo
make_soporific	soporo
cause_sleep_or_render_sleepy	soporo
dew	ros
Lethean	Lethaeus
oblivious	Lethaeus
of_Lethe	Lethaeus
fasten_to	adfigo
clear_sky	serenum
false	fallax
treacherous	fallax
deceitful	fallax
ignore	ignoro
not_know	ignoro
for_short_while	paulisper
steal	furor
Iasides	Iasides
word	loquela
speech	loquela
talking	loquela
Phorbas	Phorbas
dream	somnium
murky	tenebrosus
dark	tenebrosus
left	sinister
Cymodoce	Cymodoce
Thalia	Thalia
Spio	Spio
Nisaee	Nisaee
Melite	Melite
Thetis	Thetis
waters_or_waves_on_the_left_hand	laeva
the_left_hand_places	laeva
Palaemon	Palaemon
pertaining_Ino	Inous
Glaucus	Glaucus
whale_or_other_large_secreature	cetus
the_thunderer	tonans
thundering	tonans
calm	permulceo
stroke	permulceo
Avernus	Avernus
violating_one's_oath	periurus
roll_out_or_forth	evolvo
drive	impingo
fasten_upon	impingo

deprive_of_life	exanimo
tamer	domitor
Laurentine	Laurens
foully	foede
shamefully	foede
pertaining_Aeolus	Aeolius
witness	testis
not_long_ago	nuper
annihilate	perimo
take_away_completely	perimo
eat_out	exedo
break	infringo
break_in	infringo
soothe	mitigo
make_soft_or_mild	mitigo
that_can_satisfied	exsaturabilis
ewe_lamb	agna
young_bullock	vitulus
kindred	consanguineus
having_common_blood	consanguineus
endurable	tolerabilis
curved_forward	procurvus
of_Anchises	Anchiseus
Idalian	Idalius
of_Idalius	Idalius
pertaining_Eryx	Erycinus
forum	forum
plough	aratrum
arrange	designo
mark_out	designo
vigorous	vividus
lively	vividus
boat	navigium
enroll	transcribo
transfer_by_writing	transcribo
communicate	edoceo
teach_completely	edoceo
summon	arcesso
fetch	arcesso
an_incense_box	acerra
household_god	Lar
Lar	Lar
rush_forth	proripio
snatch_forth	proripio
gasping	anhelus
panting	anhelus
Elysium	Elysium
charming	amoenus
conflict	congressus
coming_together	congressus
subdue	debello
put_down_by_war	debello
war_the_end	debello
gathered	lectus
expel	depello
drive_off	depello

carry_up	subveho
Acesta	Acesta
not_strong	invalidus
draw_back	retraho
he_begins_speak	infit
one_begins	infit
Nautes	Nautes
drip	madesco
become_wet	madesco
height	arduum
high_place	arduum
bring_forth	edo
emit	edo
hostile	exosus

hating_much	exosus
useful	prosum
heat	vapor
steam	vapor
vapor	vapor
belch	vomo
vomit	vomo
tow	stuppa
the_calking_of_ship	stuppa
the_coarse_part_of_flax	stuppa
on_that_account	idcirco
completely_hollow	concavus
in_anywhere	sicubi
hasten	accelero
hold_back	retineo
pertaining_horseman	equester
Eumelus	Eumelus
wedge	cuneus
look_at	specto
grudging	malignus
malicious	malignus
wicked	malignus
malignant	malignus
Pyrgo	Pyrgo
age	natus
birth	natus
amaze	stupefacio
shake	corusco
move_quickly_hither_and_thither	corusco
push_with_the_horns	corusco
unfortunate	infaustus
measure_out_or_off	emetior
Doryclus	Doryclus
of_Tmaros	Tmarius
Beroe	Beroe
harm	noceo
the_seashore	acta
Trojan_woman	Troas
pass	trames
by_path_or_narrow_way	trames
crossway	trames
glut	saturo
fill	saturo
of_space_and_time	hactenus
so_far	hactenus
thus_far	hactenus
far_off	porro
or_of_mental_operations	porro
time	porro
of_space	porro
forward	porro
ancient	priscus
of_Carpathus	Carpathius
that_can_not_gone_over_again	inremeabilis
not_overtaken	indeprensus
the_Labyrinth	Labyrinthus
hinder	impedio
retreat	recursus
return	recursus
running_back	recursus
ride_in_different_directions	discurro
run_apart	discurro
scourge_or_whip	flagellum
bright	candidus
clear	candidus
shining_white	candidus
of_the_Atii	Attius
Atys	Atys
of_two_colors	bicolor
increase	augeo
an_audience	circulus
group_of_people	circulus
chain	circulus
ring	circulus
circle_or_orbit	circulus
turn_round	obtorqueo
pliant	flexilis
flexible	flexilis
fasten_before	praefigo
shine	luceo
troop	turma
boyish	puerilis
Epytides	Epytides
not_full_grown	impubes
prefer	praefero
call	appello
Cisseus	Cisseus
Thracian	Thracius
or_part	exsors
lot	exsors
without_share	exsors
thunder_at	attono
flash_or_shoot_across	transcurro
run_across	transcurro
causing_terror	terrificus
fall	decido
fall_down	decido
applaud	plaudo
approve	plaudo
clap	plaudo
strike	plaudo
pale_yellow	lineus
flaxen	lineus
strike_asunder	diverbero
string	nervus
cord	nervus
tendon	nervus
muscle	nervus
draw_forth	depromo
bend	incurvo
bend_in	incurvo
sit_or_settle_down	subsido
Pandarus	Pandarus
Eurytion	Eurytion
Hippocoon	Hippocoon
Hyrtacides	Hyrtacides
mast	malus
standing_pole	malus
crush	effringo
break_out_or_open	effringo
balance	libro
vomit	eiecto
cast_forth	eiecto
coarse	crassus
crass	crassus
fat	crassus
thick	crassus
on_both_sides	utroque
separate	dirimo
take_asunder	dirimo
madness	dementia
run_to	accurro
Erymanthus	Erymanthus
foresee	praevideo
see_beforehand	praevideo
an_assault	adsultus
leaping_upon	adsultus
fort	castellum
castle	castellum
attack	oppugno
strong	valens
provoke	lacesso
unfrightened	interritus
finger	digitus
throw_back	reicio
old_age	senectus
descendant_of_Alceus	Alcides
the_brain	cerebrum
taint	inficio
impart_some_foreign_quality_an_object	inficio
Hercules	Hercules
Anchisiades	Anchisiades
sew_or_stitch_in	insuo
lead	plumbum
youthful_vigor	iuventas
the_age_of_youth	iuventas
youthfulness	iuventas
exhausted	effetus
cold	frigeo

blunt	hebeo
old_age	senecta
loiter	tardo
hardy	patiens
patient	patiens
long_suffering	patiens
green	viridans
Entellus	Entellus
till_when	quousque
until_what_time	quousque
lively	alacer
lead_in	induco
extend	protendo
stretch_forth_or_out	protendo
stretch	extendo
stretch_forth	extendo
strike	percello
of_Bebrycia	Bebrycius
or_Bithynian	Bebrycius
Bebrycian	Bebrycius
Butes	Butes
Dares	Dares
comfort	solacium
announce	propono
propose	propono
unfasten	refigo
Didymaon	Didymaon
damp	udus
wet	udus
it_moves_pity	miseret
burdensome	onerosus
declare	proclamo
cry_out	proclamo
support	adiuvo
assist	adiuvo
help	adiuvo
goodwill	favor
that_part_of_the_theater_or_circus_which_was_occupied_by_the_spectators	cavea
hollow_place	cavea
dung	fimus
mire	fimus
waver	titubo
in_doubt	titubo
make_wet	madefacio
come_rapidly_nearer	advento
shoe	calx
the_heel	calx
an_interval	intervallum
the_space_between_two_stakes	intervallum
satisfied	contentus
content	contentus
polished	teres
tapering	teres
belt	balteus
fill	circumamplector
encircle	circumamplector
Amazonian	Amazonius
ornaments	phalerae
horse_ornaments	phalerae
metal_disks	phalerae
olive	oliva
arrow	spiculum
sting	spiculum
sharp_point	spiculum
no_one	nemo
customary	adsuetus
usual	adsuetus
Panopes	Panopes
Tegean	Tegeaeus
of_Tegea	Tegeaeus
of_Arcadia	Arcadius
of_Acarnania	Acarnan
Patron	Patron
Salius	Salius
Diores	Diores
Euryalus	Euryalus
Nisus	Nisus
invite	invito
an_assembly_(others	consessus
sitting_together	consessus
grassy	gramineus
Pholoe	Pholoe
Cretan_woman	Cressa
female_slave	serva
wind_together	plico
struggle_forward_on	nixor
lean_upon_with_the_ideof_effort	nixor
restrain	retento
hold_back	retento
lame	claudus
limping	claudus
twisting	tortus
wayfarer	viator
traveler	viator
mangled	lacer
torn	lacer
half_dead	seminex
covert	obliquus
indirect	obliquus
slanting	obliquus
maimed	debilis
disabled	debilis
ribbon	taenia
crown	evincio
bind_round	evincio
crimson	Puniceus
reddish	Puniceus
wander_about	palor
struggle	conitor
lean_or_brace_one’s_self_against	conitor
Sagaris	Sagaris
Phegeus	Phegeus
defense	tutamen
means_of_protection	tutamen
concede	dono
give	dono
take_away_from	detraho
Demoleos	Demoleos
baying	latratus
barking	latratus
pant	anhelo
full_of_leaves	frondosus
river_of_Ionia	Maeander
Maeander	Maeander
crimson	purpura
purple	purpura
special	praecipuus
peculiar	praecipuus
veil	advelo
reveal	declaro
make_clear	declaro
auctioneer	praeco
herald	praeco
Portunus	Portunus
Panopea	Panopea
Phorcus	Phorcus
fling_the_ground	proicio
throw_out	proicio
cast_forth	proicio
defendant	reus
incite	instigo
goad_on	instigo
strip	spolio
brood	nidus
nest	nidus
pumice_stone	pumex
porous	latebrosus
full_of_holes	latebrosus
pole	contus
pole	trudis
covered_with_iron	ferratus
creak	crepo
rattle	crepo
run_forth_or_forward	procurro
push_up_to	suburgeo
puffing	anhelitus
hard_breathing	anhelitus
withdraw	subtraho
draw_from_beneath	subtraho
make_ashamed	pudeo
pursuing	sequax
following	sequax
Malea	Malea
striving_equal	aemulus

go_before	praeeo
vomit	revomo
vomit_back_or_up	revomo
the_top	summum
drunk	madidus
wet	madidus
moist	madidus
purple_stripe_on_the_tunic 	clavus
nail	clavus
tiller	gubernaculum
helm	gubernaculum
cast_down	deturbo
an_oar_blade	palmula
small_palm	palmula
on_the_left	laeva
Menoetes	Menoetes
director	rector
plow	sulco
leap_back_or_again	resulto
resound	consono
sound_loudly	consono
sound_at_once_or_together	consono
beating_or_blow_with_whip	verber
whip	verber
charioteer	auriga
yoked	biiugus
of_two_horse_team	biiugus
speaker's_platform	rostrum
prow	rostrum
beak	rostrum
cut	infindo

the_arm	lacertus
induce	adduco
lead_to	adduco
leap_or_spring_forth	prosilio
become_bright	nitesco
of_the_poplar_tree	populeus
seabird	mergus
gull	mergus
open_the_sun	apricus
the_northwest_wind	Caurus
Corus_or_Caurus	Caurus
Cluentius	Cluentius
Centaur	Centaurus
of_Sergius	Sergius
line	versus
threefold	triplex
Chimaera	Chimaera
Memmius	Memmius
sea_monster	pristis
enter	ineo
talent	talentum
circle	circus
bordering	finitimus
Phaëthon	Phaethon
live_coal	pruna
Acheron	Acheron

or_make_black	nigro
tutelar_deity	genius
the_birth_spirit	genius
devour	depasco
slippery	levis
smooth	levis
brightness	fulgor
flash	fulgor
lightning	fulgor
scale_of_fishes	squama
calmly	placide
gently	placide
7_each	septeni
circle	gyrus
imperative	salveo
well	salveo
bowl	carchesium
large_drinking_vessel_with_two_handles	carchesium
pure_undiluted	merus
mature	maturus
Helymus	Helymus
girdle_of_Venus	caestus
thongs_or_straps_loaded_with_lead	caestus
dyspeptic	crudus
raw	crudus
bloody	crudus
apply	adhibeo
create	genero
sire	genero
every_year	quotannis
the_set_piece_at_banquet	pompa
parade	pompa
procession	pompa
understand	deprehendo
seize	deprehendo
catch	deprehendo
respected	honoratus
yearly	annuus
of_the_year	annuus
call	advoco
summon	advoco
Crinisus	Crinisus
bear	ursa
she_bear	ursa
Libyan	Libystis
an_arrival	adventus
rise_together	consurgo
evening_star	vesper
evening	vesper
across_the_path_or_course	transversus
make_solemn_promise	spondeo
bend	obliquo
why	quianam
slip	dilabor
Dis	Dis
fly_down	devolo
dewy	roscidus
dew_covered	roscidus
condemn	damno
Proserpina	Proserpina
Iris	Iris
death	obitus
going_down	obitus
downfall	obitus
difficult	difficilis
the_elbow	cubitum
make_dry	sicco
half_alive	semianimis
breath	halitus
breathing	halitus
fraud	fraus
shout	clamo
call	clamo
fist	pugnus
talon	unguis
claw	unguis
fingernail	unguis
yelling	ululatus
wailing	lamenta
imprint	imprimo
apply_with_pressure	imprimo
excessively	nimium
very_clear	praeclarus
loosen_completely	exsolvo
frenzied	furibundus
raging	furibundus
burst_in	irrumpo
cheek	gena
mark	interfundo
besprinkle	interfundo
pour_between	interfundo
spot	macula
frantic	efferus
savage	efferus
an_undertaking	coeptum
thing_begun	coeptum
old_woman	anilis
funeral_pyre	rogus
expiatory	piaculum
an_expiation	piaculum
pertaining_river_or_stream	fluvialis
Barce	Barce
as_soon_as_possible	quam
call_down_good_or	imprecor
report	trado
hand_over	trado
implore	imploro
exiled	extorris
attack	vexo
annoy	vexo
reckless	audax
bold	audax
limit	terminus
boundary_line	terminus
gutter	trivium
crossroads	trivium
the_inferior	forus
gangway_between_the_rowing_benches_of_ship	forus

grace	decet
become	decet
adorn	decet
pertaining_ships	navalis
naval	navalis
new_comer	advena
wow	pro

yellow	flaveo
an_oarsman	remex
grow_white	albesco
mirror	speculum
Tithonus	Tithonus
eagerness	ardor
heat	ardor
burning	ardor
halter	retinaculum
that_which_holds_back	retinaculum
flashing	fulmineus
scabbard	vagina
awake	vigilo
fickle	mutabilis
changeable	mutabilis
come_on_away	heia
shine	conluceo
lighted_up	conluceo
shine_on_every_side	conluceo
wholly_shining	conluceo
incite	concito
color	color
groans	questus
moaning	questus
complaining	questus
Sychaean	Sychaeus
pertaining_Sychaeus	Sychaeus
pass	dego
lacking	expers
Pertaining_Laomedon	Laomedonteus
ruined	perditus
gratitude	gratia
influence	gratia
favor	gratia
therefore	igitur
refuse_scornfully	dedignor
laugh_at	irrideo
one_who_asks	procus

place_one’s_self_in_or_upon_thing	insisto
wave	fluctuo
still	silens
bramble	dumus
melodious	liquidus
liquid	liquidus
clear	liquidus
loosen	recingo

mill	mola
carry_off	praeripio
snatch	praeripio
pubescent	pubens
harvest	meto
sickle	falx
scythe	falx
Avernian	Avernus
of_Avernus	Avernus
Hecate	Hecate
of_threefold_birth	tergeminus
Chaos	Chaos
the_future	futurum
funereal	funereus
fringe	praetexo
weave_in_front	praetexo
paleness	pallor
couch	lectus
bed	lectus
funeral_pile	pyra
or_magicians	magicus
pertaining_magi	magicus
the_poppy	papaver
sleep_bearing	soporifer
Hesperis	Hesperis
fitting	aptus
appropriate	aptus
fitted_to	aptus
Ethiopian	Aethiops
of_or_belonging_Ethiopia	Aethiops

wish_joy_to	grator
decide	decerno
determine	decerno
conceive	concipio
produce	concipio
Dira	Dira
Thebes	Thebae
Pentheus	Pentheus
Eumenides	Eumenides
terrify	horrifico
make_shudder	horrifico
make_rough	horrifico
terrifying	terribilis
prediction	praedictum
thing_foretold	praedictum
owl	bubo
pertaining_the_dead	feralis
fleece	vellus
marble	marmor
grow_dark	nigresco
become_or_turn_black	nigresco
incense_burning	turicremus
it_makes_tired	taedet
steady	assiduus
established	assiduus
cover	consterno
strew_over	consterno
from_there	illinc
blast	flatus
wind	flatus
blowing	flatus
pertaining_the_Alps	Alpinus
old	annosus
aged	annosus
stop	obstruo
build_before_or_against	obstruo
pile_on	cumulo
heap_up	cumulo
space	spatium
pluck_out	revello
pull_back	revello
take_an_oath	iuro
swear	iuro
Aulis	Aulis
unacquainted_with	inexpertus
chastise	castigo
crops	frumentum
grain	frumentum
thrust	trudo
large	grandis
full_grown	grandis
path	callis
carry	convecto
pile	acervus
heap	acervus
spelt	far
an_ant	formica
depart	migro
go	migro
unfashioned	infabricatus
unwrought	infabricatus
anoint	unguo
persist	exsequor
accomplish	exsequor
follow	exsequor

cause_totter_or_waver	labefacio
of_marble	marmoreus
sink_down	conlabor
fail	conlabor
slip_or_fall_together	conlabor
separate	seduco
lead_apart_or_away	seduco
punishment	supplicium
refute	refello
disparage	refello
stir_up	sollicito
seer	augur
prefer	antefero
bear_before	antefero
whether	num
reserve	reservo
tiger	tigris
of_or_from_Hyrcanus	Hyrcanus
Caucasus	Caucasus
voluntarily	sponte
complaint	querela
cease	desino
leave_off	desino
act_illegally	fraudo
cheat	fraudo
defraud	fraudo
remind	admoneo
admonish	admoneo
fiery	igneus
hide	operio
cover	operio
Gryneian	Gryneus
of_Gryni	Gryneus
rebuilt	recidivus
returning	recidivus
falling_back	recidivus
free_will	spons
theft	furtum
spirit	spiritus
breath	spiritus
Elissae	Elissa
it_disgusts	piget
deserve	promereor
merit_for_one's_self_by_favors_given	promereor
enumerate	enumero
count_out_or_completely	enumero
press	obnitor
advice	monitum
counsel	monitum
an_admonition	monitum
entirely	omnino
very_small	parvulus
twig	suboles
shoot	suboles
destroy	destruo
since	quoniam
ready_die	moribundus
nomas	nomas
because_of	propter
another's	alienus
unrelated	alienus
strange	alienus
withdraw	decedo
move_away	decedo
false	perfidus
treacherous	perfidus
faithless	perfidus
Cithaeron	Cithaeron
nocturnal	nocturnus
the_rites_of_Bacchus	orgia
triennial	trietericus
rouse	stimulo
spur	stimulo
Thyias	Thyias
poor	inops
lacking	inops
movement	motus
motion	motus
feel_beforehand	praesentio
perform	facesso
do_effectively	facesso
swifter	ocior
Mnestheus	Mnestheus
weigh_or_consider_one_thing_after_another	alterno
alternate_by_turns	alterno
do_by_turns	alterno
there	illuc
origin	exordium
beginning	exordium
address	adfatus
speaking_to	adfatus
encompass	ambio
aim_at	ambio
strive_for	ambio
go_round	ambio
an_admonition	monitus
silent	obmutesco
become_speechless_or_dumb	obmutesco
disappear	evanesco
heir	heres
leisure	otium
use_up	tero
wear_away	tero
rub	tero
commission	mandatum
order	mandatum
subservient_wife	uxorius
pertaining_wife	uxorius
web	tela
cloak	laena
an_upper_garment	laena

sharp_pointed_shellfish_from_which_was_obtained_the_Tyrian_purple	murex
the_murex_or_purple_fish	murex
jasper	iaspis
precious_stone_of_greenish_hue	iaspis

stud_with_stars	stello
cover_over_with_stars	stello
renew	novo
make_new	novo
found	fundo
sole_of_the_foot	planta
twig	planta
sprout	planta
winged	alatus
sandy	harenosus
abounding_in_fish	piscosus
bird	avis
Cyllenian	Cyllenius
ice	glacies
old_man	senex
snow	nix
pine_bearing	pinifer
constantly	adsidue
perpetually	adsidue
reinforce	fulcio
fortify	fulcio
strengthen	fulcio
swim_or_sail_across	trano
fould	turbidus
confused	turbidus
leaning_on	fretus

unseal	resigno
the_underworld	Tartarus
Tartarus	Tartarus
the_infernal_regions	Tartarus
summon	evoco
call_out	evoco
stick	virga
blast	flamen
gust	flamen
winged_sandals	talaria
sandals	talaria
sum	summa
peak	summa
envy	invideo
heavy	gravidus
claim	vindico
for_this_reason	ideo
Mercurius	Mercurius
plunder	raptum
damp	madeo
wet	madeo
turban	mitra
headband	mitra
chin	mentum
of_Maeonia	Maeonius
suite	comitatus
an_accompanying_or_following	comitatus
half_man	semivir
payment	pretium
value	pretium
price	pretium
little	exiguus
small	exiguus
affright	terrifico
Lenaeus	Lenaeus
Mauretanian	Maurusius
Moorish	Maurusius
harsh	amarus
bitter	amarus
rumor	rumor
bloom	floreo
watch	excubiae
the_keeping_of_watch	excubiae
of_the_Garamantes	Garamantis
Garamantian	Garamantis
Zeus_Ammon	Hammon
pile_up	aggero

sway_(opinions	detorqueo
turn_aside	detorqueo
turn_away	detorqueo
unworked	infectus
not_done	infectus
manifold	multiplex
having_many_folds	multiplex
messenger	nuntia
tenacious	tenax
crooked	pravus
falsehood	fictum
affright	territo
fill_with_alarm	territo
of_the_eyes	declino
turn_down_or_away	declino
raise_up	subrigo
agile	pernix
bear	progigno
beget	progigno
Coeus	Coeus
maintain	perhibeo
hold_persistently	perhibeo
exasperate	inrito
seek_in_addition	adquiro
swiftness	mobilitas
moveableness	mobilitas
fast	velox
protect	praetego
cover_over	praetego
furtive	furtivus
secret	furtivus
shine	fulgeo
bridal_	pronuba
presiding_over_marriage	pronuba
aiding_in_marriage_rites	pronuba
go_by	praetereo
dusty	pulverulentus
covered_with_dust	pulverulentus
broad	patens
open	patens
goatish_smell	capra
she_goat	capra
shine_forth	eniteo
of_or_from_the_Agathyrsi	Agathyrsus
Dryopes	Dryopes
Cretan	Cres
come	inviso
maternal	maternus
Delos	Delos
stream	fluentum
Lycia	Lycia
clasp	fibula
bind	nodo
tie_with_knot	nodo
border	limbus
_horse	sonipes
delay	cunctor
keen_scented	odorus
horseman	eques
Libyan	Massylus
Massylian	Massylus
hunting_spear	venabulum
snare	plaga
net	plaga
trap	rete
net	rete
brightness	iubar
find_out	reperio
laugh	rideo
against	adversor
desire	voluntas
thunder	tonitrus
pour_inor_upon	infundo
toils	indago
an_inclosing_or_surrounding_of_the_woods_with_the_hunting_nets	indago
hail	grando
black	nigrans
beam	radius
ray	radius
Titan	Titan
rising	ortus
birth	ortus
pertaining_tomorrow	crastinus
go_hunting	venor
hunt	venor
brought_together	confio
approve	probo
prefer	malo
deny	abnuo
refuse	abnuo
pertaining_dowry	dotalis
agree	paciscor
feel	persentio
feel_deeply	persentio
as_soon_as	simulac
interrupt	interrumpo
break_asunder	interrumpo
defense	propugnaculum
in_turn	vicissim
stick	harundo
reed	harundo
fatal	letalis
deadly	letalis
pasture	saltus
fleeting	volatilis
able_fly	volatilis
Cretan	Cressus
hind	cerva
middle	medulla
marrow	medulla
eat	edo
entrails	exta
plan	consulo
consult	consulo
inspect	inhio
gape_at_or_over	inhio
walk_about	spatior
cow	vacca
law_bringing	legifer
hoe	bidens
mattock	bidens
set_on_fire	inflammo
ignite	inflammo
ample	impensus
yielding	tractabilis
indulgent	tractabilis
rainy	aquosus
abounding_in_water	aquosus
rage	desaevio
rage_furiously	desaevio
bind	innecto
of_or_from_the_Barcaei	Barcaeus
thirst	sitis

unfriendly	inhospitus
riding_without_bridle	infrenus
unbridled	infrenus
Numidian	Numida
that_can_not_surmounted	insuperabilis
Gaetulus	Gaetulus
fight	pugno
agreeable	placitus
Africa	Africa
Iarbas	Iarbas
continuous	perpetuus
decency	pudor
Erebus	Erebus
pale	palleo
force_to	adigo
drive_to	adigo
feeling	sensus
fraternal	fraternus
succumb	succumbo
fall_down	succumbo
torch	taeda
it_wearies	pertaedet
yoked	iugalis
accuse	arguo
declare	arguo
dream	insomnium
sleeplessness	insomnium
Anna	Anna
sound	sanus
of_one_mind	unanimus
vein	vena
recount	renarro
relate_again	renarro
relief	levamen
an_alleviation	levamen
joyless	inlaetabilis
Drepanum	Drepanum
of_Lilybaeum	Lilybeius
Selinus	Selinus
full_of_palm_trees	palmosus
breeder	generator
one_who_begets	generator
display	ostento
Acragas	Acragas
Gela	Gela
of_Gela	Gelous
belonging_Gela	Gelous
Camarina	Camarina
inscribe	rado
scratch	rado
shave	rado
projecting	proiectus
Helorus	Helorus
stagnant	stagno
very_fat	praepinguis
pour_together	confundo
Arethusa	Arethusa
beneath	subter
below	subter
Elis	Elis
Alpheus_River	Alpheus
stormy	undosus
billowy	undosus
Plemyrium	Plemyrium
stretch_forth	praetendo
hold_out_before	praetendo
Sicanian	Sicanus
Sicilian	Sicanus
back	retrorsus
backwards	retrorsus
pass_by	relego
gather_again	relego
Thapsus	Thapsus
of_or_belonging_Megara	Megarus
Pantagias	Pantagias
pass	praetervehor
go_by	praetervehor
the_god_of_the_North_Wind	Boreas
sail	linteum
sailcloth	linteum
napkin	linteum
linen_cloth	linteum
cypress	cyparissus
cone_bearing	conifer
an_oak_tree	quercus
Aetnaean	Aetnaeus
of_Aetna	Aetnaeus
call_forth	excio
rouse_up_or_forth	excio
summon	excio
roar	immugio
bellow_within	immugio
powerful	potis
power	potestas
grasp_at	adfecto
strive_after	adfecto
cut	incido
cut_upon	incido
cut_into	incido
gnash	infrendeo
wash	lavo
running	fluidus
flowing	fluidus
solace	solamen
means_of_consoling	solamen
pleasure	voluptas
sheep	ovis
pine_tree	pinus
stripped_of_its_branches	truncus
take_away	adimo
more	potius
rather	potius
sell	addico
pronounce_for	addico
look_at	conlustro
cast_light_upon	conlustro
the_cornel_cherry_or_cornel_berry	cornum
stony	lapidosus
pearl	baca
berry	baca
tremble	tremesco
begin_tremble	tremesco
the_national_lustrum_or_atoning_sacrifice	lustrum
purifying_atonement	lustrum
commonly	vulgo
squeeze	presso
press_hard	presso
wool_bearing	laniger
Polyphemus	Polyphemus
light	lampas
pertaining_Phoebeus_or_Apollo	Phoebeus
wild	torvus
stern	torvus
mix_together	commisceo
bend	inflecto
moreover	quidem
with_impunity	impune
tooth	dens
chew	mando
swim	nato
sprinkle_upon	aspergo
easy_approached	adfabilis
Adamastus	Adamastus
Achaemenides	Achaemenides
put_down	depono
pledge	pignus
plunge_into	immergo
of_Danaus	Danaus
lead/take_away	abduco
breathable	spirabilis
vital	spirabilis
terrify	conterreo
frighten_greatly	conterreo
little	paulum

thorn	spina
dirt	inluvies
that_which_is_deposited_by_washing	inluvies
mode_of_life	cultus
dress	cultus
civilization	cultus
cultivation	cultus
finish	conficio
emaciation	macies
remove	dimoveo
move_apart_or_away	dimoveo
moist	umeo
wet	umeo
the_dawn_god	Eous
Eous	Eous
gloomy	intempestus
unpleasant	intempestus
unseasonable	intempestus
rain_clouds	nubila
starry	sidereus
heaven	aethra
serene_sky	aethra
the_cloudless_air	aethra
shining	lucidus
bright	lucidus
cover	subtexo
veil_or_cover_from_below	subtexo
weave_beneath	subtexo
tremble	intremo
whenever	quotiens
how_many_times	quotiens
forge	caminus
furnace	caminus
stove	caminus
half_burned	semustus
Enceladus	Enceladus
boil_up	exaestuo
melt	liquefacio
dissolve	liquefacio
vomit	eructo
belch_out	eructo
globe	globus
any_body_of_spherical_form	globus
ashes	favilla
brillant	candeo
shine	candeo
of_pitch	piceus
pitch_black	piceus
thunder	tono
going_near_to	accessus
Cyclops	Cyclops

moist_with_dew	roro
dash_forth	elido
kill	elido
crush	elido
sink_down	desido
troop	cohors
band	cohors
cohort	cohors
send_forth_loud	rudo
undoubtedly	nimirum
hit	pulso
Aetna	Aetna
Scylaceum	Scylaceum
shipwrecking	navifragus
Caulon	Caulon
of_Lacinium	Lacinius
Tarentum	Tarentum
Herculean	Herculeus
of_Hercules	Herculeus
Graiugena	Graiugena
sail_yard	antenna
turn_towards	obverto
connected	continuus
with_resounding_arms	armisonus
of_one_mind	concors
reins	frenum
bridle	frenum
horse	quadrupes
on_all_fours	quadrupes
four_footed	quadrupes
become_accustomed	suesco
snowy	nivalis
shining	candor
turreted	turritus
craggy_or_pointed_rock	cautes
spray	aspargo
sprinkling_upon	aspargo
bend	curvo
south_eastern	Eurous
become_frequent	crebresco
greet	saluto
humble	humilis
begin_glow	rubesco
grow_or_turn_red	rubesco
stand_firm	consto
remain_unchanged	consto
agree	consto
censure	noto
sign	noto
mark	noto
hunt_for_legacies	capto
seize	capto
slow	segnis
hour	hora
overshadow	umbro
Ceraunia	Ceraunia
near_by_birth	cognatus
finish	perago
appear	oborior
arise	oborior
growing_up	pubesco
of_the_same_age	aequalis
equal	aequalis
woven	textilis
mantle_or_cloak_of_woolen_cloth	chlamys
the_cross_thread	subtemen
that_which_is_woven_under_or_passed_under_or_across_the_warp_in_weaving	subtemen
embroidered	picturatus
adorned_with_painting	picturatus
departure	digressus
going_away	digressus
beyond	ultra
necessary	necesse
glide	praeterlabor
seize	arripio
snatch	arripio
Ausonia	Ausonia
consider_worthy	digno
supply	suppleo
fill_up	suppleo
crest	crista
the_metallic_point_or_apex_of_helmet	conus
cone	conus
triple	trilix
of_three_threads	trilix
hook	hamus
hauberk	lorica
corselet_of_any_material	lorica
leather_corselet	lorica
kettle_or_caldron	lebes
Dodonaean	Dodonaeus
of_Dodona	Dodonaeus
control	impero
command	impero
elephant	elephantus
willing	volens
loss	dispendium
expenditure	dispendium
Sibylla	Sibylla
without_advice	inconsultus
situation	situs
fly_around	volito
but_indeed	verum
transcribe	describo
describe	describo
note	nota
mark	nota
Avernus	Averna
of_Cumae	Cumaeus
Cumaean	Cumaeus
the_three_cornered_land	Trinacria
willing	libens
foresight	prudentia
resound	resono
dog	canis
deprived_of_beauty	informis
shapeless	informis
once	semel
how	quam
as	quam
than	quam
turn_far_round	circumflecto
bend_around	circumflecto
Pachynum	Pachynus
coda	cauda
the_tail	cauda
dolphin	delphinus
semonster	pistrix
next	posterus
stretch_or_thrust_forth	exserto
hold_together	cohibeo
beat	verbero
flog	verbero
whip	verbero
one_after_the_other	alternus
erect	erigo
set_up	erigo
absorb	sorbeo
suck	sorbeo
an_abyss	barathrum
Charybdis	Charybdis
unappeased	implacatus
Scylla	Scylla
flow_between	interluo
wash_between	interluo
separate	diduco
draw_apart	diduco
tear_off	abscindo
rent_asunder	dissilio
burst_asunder	dissilio
spring_apart	dissilio
age	vetustas
remote	longinquus
circle	circuitus
circuit	circuitus
Pelorus	Pelorus
open	raresco
part_or_begin_stand_open	raresco
become_thin	raresco
bring_to	admoveo
move_to	admoveo
pure	castus
cover_up	adoperio
across	trans
Petelia	Petelia
Philoctetes	Philoctetes
of_Meliboea	Meliboeus
Cretan	Lyctius
Lyctian	Lyctius
of_Lyctus	Lyctius
of_or_from_the_Sallentini	Sallentinuus
of_or_from_Locri	Locrus
Locrian	Locrus
of_Naryx	Narycius
repose	requies
lie	recubo
extended	recubo
recline	recubo
lying_back_or_down	recubo
the_holm_oak	ilex
of_the_seashore	litoreus
littoral	litoreus
worried	sollicitus
Circe	Circe
Aeaean_or_Colchian	Aeaeus
of_Aeae	Aeaeus
that_which_lies_beneath	infernus
lower	infernus
of_oars	lento
make_flexible	lento
welcoming	hospitus
that	quo
authority	auspicium
divination	auspicium
prevail_upon	exoro
entreat	exoro
pray_effectually	exoro
denounce	denuntio
prognostic	prodigium
treasured_up	repositus
replaced	repositus
successful	prosper
auspicious	prosper
favorable	prosper
fleet	praepes
swift	praepes
hastening_before	praepes
Clarian	Clarius
of_Claros	Clarius
tripod	tripus
three_footed_vessel_or_seat	tripus
mediator	interpres
an_agent_between_parties	interpres
of_Trojan_descent	Troiugena
beg	quaeso
linen	carbasus
fill	inflo
blow_into	inflo
middle	medium
enjoy	fruor
stream	rivus
brook	rivus
in_vain	incassum
maternal_uncle	avunculus
manly	virilis
anyone_anything	ecquid
whether_any	ecquis
who	quisnam
Chaon	Chaon
Chaonia	Chaonia
Orestes	Orestes
bear_or_convey_across_or_over	transmitto
send_across	transmitto
Spartan	Lacedaemonius
Lacedaemonian	Lacedaemonius
Hermione	Hermione
pertaining_Leda	Ledaeus
give_birth_to	enitor
strive	enitor
struggle	enitor
haughtiness	fastus
Achillean	Achilleus
of_Achilles	Achilleus
bed	cubile
couch	cubile
master	erus
an_owner	erus
allotment	sortitus
drawing_of_lots	sortitus
hostile	hostilis
modest	demissus
hanging_down	demissus
eject	deicio
throw_down	deicio
gape	hisco
bring_to	affero
warmth	calor
alarm	exterreo
frighten	exterreo
turf	caespes
go_forward	progredior
husband	maritus
Helenus	Helenus
Priamides	Priamides
anticipate	occupo
seize	occupo
incredible	incredibilis
Buthrotum	Buthrotum
Chaonian	Chaonius
of_Chaonia	Chaonius
Epiros_or_Epirus	Epiros
put_out_of_sight	abscondo
Phaeaces	Phaeaces
pertaining_the_air	aerius
thwart	transtrum
cross_timber	transtrum
equipment	gestamen
that_which_is_carried	gestamen
raise	aspero
make_rough	aspero
icy	glacialis

roll_round	circumvolvo
place_for_wrestling_or_exercise	palaestra
olive_oil	oleum
game	ludus
pertaining_Actium	Actius
unhoped_for	insperatus
throw	iacio
dread	formido
in_dread	formido
point	cacumen
Leucat	Leucates
then	mox
soon	mox
execrate	exsecror
curse_bitterly	exsecror
mother	altrix
nurse	altrix
of_Laertes	Laertius
Ithaca	Ithaca
Neritos	Neritos
Same	Same
Dulichium	Dulichium
Zacynthus	Zacynthus
woody	nemorosus
helmsman	gubernator
tear_down	deripio
snatch_away	deripio
battlements	minae
threats	minae
beg	exposco
ask_importunately	exposco
cold	derigesco
grow_completely_stiff	derigesco
feather	penna
wing	penna
cheek	mala
consume	ambedo
eat_round	ambedo
before	antequam
fury	furia
foretell	praedico
say_beforehand	praedico
Laomedontiades	Laomedontiades
bullock	iuvencus
young_bull	iuvencus
lofty	praecelsus
very_high	praecelsus
half_eaten	semesus
down	pluma
feather	pluma
ill_boding	obscenus
filthy	obscenus
Misenus	Misenus
watch_tower	specula
lookout	specula
distribute	dispono
arrange	dispono
place	dispono
proclaim	edico
make_known	edico
vile	taeter
disagreeable	taeter
foul	immundus
unclean	immundus
touch	contactus
touching_together_or_upon	contactus
fear_inducing	horrificus
terrible	horrificus
banquet	epulor
raise	exstruo
erect	exstruo
build_up	exstruo
pertaining_goats	caprigenus
enter	intro
excrement	proluvies
flowing_forth	proluvies
foul	foedus
bird	volucris
pertaining_Styx	Stygius
Stygian	Stygius
pertaining_Phineus	Phineius
Harpyia	Harpyia
Celaeno	Celaeno
Ionian	Ionius
Ionic	Ionius
Strophades	Strophades
sailor	nauta

rise_to	insurgo
4th	quattuor
4	quattuor
mist	caligo
Palinurus	Palinurus
determine	discerno
distinguish_one_thing_from_another	discerno
make_cuts	aufero
take_away	aufero
sprinkle	dispergo
continuously	continuo
immediately	continuo
of_the_sea	inhorresco
rough	inhorresco
above	supra
celebrate_an_ovation	ovo
shout	ovo
stretch	portendo
cheat	decipio
deceive	decipio
accomplish	perficio
complete	perficio
on_the_back	supinus
vision	visum
astonished	attonitus
of_Dicte	Dictaeus
Italian	Ausonius
Ausonius	Ausonius
Corythus	Corythus
doubt	dubito
hesitate	dubito
Iasius	Iasius
Dardanus	Dardanus
Delian	Delius
of_Delos	Delius
traverse	permetior
measure_completely	permetior
confer	defero
report	defero
carry_away	defero
insert	insero
fasten_or_put_in	insero
animal	animal
pray	precor
beg	precor
wither	areo
dry	areo
Sirius	Sirius
unfruitful	sterilis
unproductive	sterilis
death_bringing	letifer
pestilence	lues
pitied	miserandus
dragging	tractus
emaciated	tabidus
melting_away	tabidus
occupied_with	operor
work	operor
almost	fere
fireplace	focus
love	amo

glide_to	adlabor
Curetes	Curetes
ancestor	proavus
great_grandfather	proavus
struggle	certamen
contest	certamen
of_ships	nauticus
sow_or_plant	consero
Cyclades	Cyclades
Paros	Paros
Olearos	Olearos
Donus	Donusa
Naxos	Naxos
rage	bacchor
revel	bacchor
Ortygia	Ortygia
Idomeneus	Idomeneus
paternal	paternus
white	albus
due	meritus
deserved	meritus
Cretan	Cretaeus
of_Crete	Cretaeus
distant	disto
stand_apart	disto
of_Gnosus	Gnosius
mistress	domina
Corybantian	Corybantius
mountain_in_Phrygia	Cybelus
protectress	cultrix
an_inhabitant	cultrix
of_Pergamum	Pergamenus
not_yet	nondum
of_Rhoeteum	Rhoeteus
remember	recordor
fruitful	uber
fertile	uber
inhabit	habito
birthplace	cunabula
cradle	cunabula
Crete	Creta
monument	monumentum
memorial	monumentum
seek_out	exquiro
place_under	sumitto

kettle	cortina
caldron	cortina
low	mugio
of_Thymbr	Thymbraeus
encircle	redimio
Anius	Anius
scorn	contemno
despise	contemno
Gyaros	Gyaros
Myconos	Myconos
bow_bearing	Arcitenens
pertaining_the_Aegean	Aegaeus
Aegean	Aegaeus
Nereis	Nereis
creak	crepito
make_rattling_noise	crepito
milk	lac
small	cymbium
tepid	tepidus
warm	tepidus
Manes	Manes
heap_upon	aggero
bear_to	aggero
soil	polluo
sever	abrumpo
break_off	abrumpo
in_triumph	victrix
female_conqueror	victrix
pertaining_Agamemnon	Agamemnonius
blockade	obsidio
siege	obsidio
distrust	diffido
northern	Threicius
Thracian	Threicius
nourish	alo
entrust	mando
dangerous	anceps
unsettled	anceps
two_headed	anceps
grow_up	incresco
grow_in	incresco
spear	iaculum
thing_hurled	iaculum
made_of_iron	ferreus
Polydorus	Polydorus
flow	mano
drip	mano
log_or_post	stipes
bloodshed	cruor
blood	cruor
strange	externus
foreign	externus
outside	externus
commit_crime	scelero
tear	lacero
disastrous	lacrimabilis
piteous	lacrimabilis
express	eloquor
speak_out	eloquor
strive	obluctor
exertion	nisus
pressure	nisus
favor	secundo
aid	secundo
correctly	rite
duly	rite
with_the_proper_rites	rite
preside_over	praesideo
sit_before	praesideo
pertaining_the_Getae	Geticus
Gradivus	Gradivus
rustic	agrestis
rural	agrestis
venerate	veneror
cork	cortex
shell	cortex
bark	cortex
osier	vimen
flexible_twig	vimen
slow	lentus
sticky	lentus
flexible	lentus
come_together	coeo
defile	maculo
stain	maculo
spot	maculo
gore	tabum
putrid_blood	tabum
corrupt_matter	tabum
drop	gutta
run	liquor
in_liquid_state	liquor
root	radix
frondens	frondeo
bear_or_put_forth_leaves	frondeo
leafy	frondeo
branch	ramus
green	viridis
myrtle	myrtus
thicket	virgultum
brambles	virgultum
of_cornel_wood	corneus

diviner	auspex
one_who_divines_by_watching_birds	auspex
pertaining_Dione	Dionaeus
enter	ingredior
step_in	ingredior
Lycurgus	Lycurgus
Thracian	Thrax
banished_person	exsul
an_exile	exsul
shrink_because_of_pain	contraho
collect	contraho
Antandros	Antandros
undeserving	immeritus
Mount_Ida	Ida
the_morning_star	Lucifer
Lucifer	Lucifer
lead_away	deduco
launch	deduco
wonder	admiror
admire	admiror
assemble	adfluo
flow_to	adfluo
consume	consumo
use_up	consumo
seize	comprehendo
unite	comprehendo
arm	brachium
attempt	conor
try	conor
thin	tenuis
hold	detineo
hold_from_or_back	detineo
divine	divus
Dardanis	Dardanis
serve	servio
Thybris	Thybris
mild	lenis
kind	lenis
gentle	lenis
Etruscan	Lydius
Lydian	Lydius
of_Lydia	Lydius
western	Hesperius
of_the_west	Hesperius
plough	aro
come_out	evenio
indulge_in	indulgeo
gratify	indulgeo
remove	demo
again	iterum
gather_together	congero
captured	captivus
watch	adservo
guard	adservo
preserve	adservo
Phoenix	Phoenix
temple	asylum
an_asylum	asylum
place_of_refuge	asylum
advance	procedo
mount_upward	exsupero
completely_above	exsupero
greedy	edax
voracious	edax
observe	observo
watch	observo
beginning	principium
throw_towards	obiecto
return	revertor
gleaming	fulgens
lacking	desum
bend_back	reflecto
weary	lassus
tired	lassus
pathless	avius
confused	confusus
mingled	confusus
little_bit	nescioquis
some_degree	nescioquis
I_know_not_who/what	nescioquis
someone_or_other	nescioquis
render_favorable	propinquo
bring_near	propinquo
not_long_ago	dudum
dark	opacus
shady	opacus
footstep	passus
pace	passus
lion	leo
hide	pellis
skin	pellis
cover	insterno
spread_over	insterno
wash_away	abluo
handle_or_touch	attrecto
walk_or_go_apart	digredior
branch_of_cypress	cupressus
the_cypress	cupressus
old	vetustus
mound	tumulus
turn_towards	adverto
track	vestigium
trace	vestigium
wherever	quocumque
whithersoever	quocumque
whatever_place	quocumque

load	gravo
burden	gravo
yield	cedo
now	iamiam
already	iamiam
smoke	fumo
sulphur	sulphur
path_crossing_the_border	limes
border	limes
of_Mount_Ida	Idaeus
star	stella
the_left_part	laevum
strengthen	firmo
deserve	mereor
earn	mereor
prayer	prex
put_out	restinguo
agitated	trepido
innocent	innoxius
harmless	innoxius
touch	tactus
touching	tactus
peak	apex
the_point_of_anything	apex
unexpected	subitus
having_come_up_suddenly	subitus
fill_up	repleo
cry_out	vociferor
raise_the_voice	vociferor
protect	tutor
beyond	extra
outside	extra
pass_through	inserto
put_or_thrust_into	inserto
unavenged	inultus
today	hodie
never	numquam
cut_pieces	obtrunco
cut_down	obtrunco
lop_off	obtrunco
remain_fixed	persto
continue_standing	persto
linger	demoror
sacrifice	iactura
loss	iactura
discover	invenio
find	invenio
solid	solidus
firm	solidus
dense	solidus
complete	integer
fresh	integer
untouched	integer
banishment	exilium
exile	exilium
bring_forward	produco
deny	abnego
descend	descendo

send_forth_sigh_or_groan	congemo
groan_deeply	congemo
for_the_last_time	supremum
sway_and_fro	nuto
nod	nuto
distract	concutio
disturb	concutio
terrify	concutio
strike	concutio
beat	concutio
shake	concutio
continuously	usque
with_striving_or_contention	certatim
cut_into	accido
mountain_ash	ornus
Neptunian	Neptunius
pertaining_Neptune	Neptunius
last	imus
deepest	imus
thick	spissus
dense	spissus
close	spissus
stir_up	suscito
Gorgo	Gorgo
effulgent	effulgo
shine_forth_or_brightly	effulgo

sit_or_seated_on	insideo
Scaea	Scaea
shake	quatio
smoke	fumus
rise_in_waves	undo
dark	caligo
impair	hebeto
make_dull	hebeto
make_blunt	hebeto
draw_over	obduco
draw_or_lead_towards	obduco
inclemency	inclementia
unkindness	inclementia
blame_censure	culpo
Lacaena	Lacaena
whither_where	quonam
put_inmotion	excito
arouse	excito
stir_up	excito
restrain	contineo
contain	contineo
god	caelicola
an_inhabitant_of_heaven	caelicola
confess	confiteor
pure	purus
satisfy_sate	satio
avenging	ultrix
praise	laudo
extinguish	exstinguo
victory	victoria
memorable	memorabilis
although	etsi
sweat	sudo
fall	occido
set	occido
go_down	occido
marriage	coniugium
joining_together	coniugium
triumph	triumphus
bring_forth	pario
Sparta	Sparta
certainly	scilicet
avenge	ulciscor

begin_burn	exardesco
secret	invisus
unseen	invisus
general	communis
common	communis
fear_beforehand	praemetuo
Helen	Tyndaris
daughter_of_Tyndarus	Tyndaris
jump	saltus
look_back	respicio
Creus	Creusa
breathe_out	exhalo
of_equal_age	aequaevus
stand_around	circumsto
the_stem	truncus
sovereign	regnator
one_who_reigns	regnator
slip_forward	prolabor
departure	exitus
hilt	capulus
the_handle	capulus
slip	lapso
fall_down	lapso
recount	narro
report	narro
tell	narro
degenerate	degener
news	nuntius
messenger	nuntius
the_boss_of_shield	umbo
noisy	raucus
harsh_sounding	raucus
unite_collect	conicio
throw_together	conicio
stroke	ictus
blow	ictus
peaceful	imbellis
unwarlike	imbellis
send_back	remitto
grave	sepulcrum
tomb	sepulcrum
blush	erubesco
grow_red	erubesco
plant	sero
ought	debeo
owe	debeo
care_for	curo
outrage	ausum
daring_deed	ausum
exclaim	exclamo
keep_away_from	abstineo
hold_back	abstineo
fall_down	concido
aggressive	infestus
hostile	infestus
empty	vacuus
portico	porticus
colonnade	porticus
covered_walk	porticus
Polites	Polites
aged	longaevus
speak	effor
speak_forth	effor
need	egeo
want	egeo
that	iste
protector	defensor
defender	defensor
youthful	iuvenalis
crowded	condensus
thick	condensus
dove	columba
pigeon	columba
high_altar	altaria
the_upper_part_of_an_altar	altaria
laurel	laurus
close	iuxta
near	iuxta
sky	axis
axle	axis
unserviceable	inutilis
useless	inutilis
aged	senex
old	senex
revolt_from	deficio
fail	deficio
barbaric	barbaricus
foreign	barbaricus
bedchamber	thalamus
marriage_bed	thalamus
consecrate	sacro
daughter_in_law	nurus
Hecuba	Hecuba
brothel	stabulum
inn	stabulum
stable	stabulum
overcome	evinco
conquer_completely	evinco
torrent	amnis
river	amnis
send_in	immitto
slaughter	trucido
entryway	aditus
an_approach	aditus
throw_off	emoveo
move_off_or_away	emoveo
door	ianua
ram	aries
worth	valeo
strong	valeo
support	suffero
frightened	pavidus
scared	pavidus
howl	ululo
feminine	femineus
shrine	aedes
building	aedes
lamentation	plangor
lamentation_by_beating_the_breast	plangor
window	fenestra
strong	firmus
firm	firmus
furnished_with_copper_or_bronze	aeratus
pluck	vello
break	perrumpo
an_ax	bipennis
of_Scyros	Scyrius
Automedon	Automedon
an_armor_bearer	armiger
charioteer	agitator
one_who_drives	agitator
Periphas	Periphas
three_forked	trisulcus
three_furrowed	trisulcus
roll_up	convolvo
roll_together	convolvo
slippery	lubricus
smooth	lubricus
bring	nitidus
shining	nitidus
winter	bruma
the_winter_solstice	bruma
cold	frigidus
cool	frigidus
herb	gramen
plant	gramen
grass	gramen
snake	coluber
Pyrrhus	Pyrrhus
entrance	vestibulum
floor	tabulatum
planking	tabulatum
joint	iunctura
joining	iunctura
give_way	labo
Greek	Achaicus
Achaean	Achaicus
of_Achaia	Achaicus
void	irritus
invalid	irritus
evade	evado
go_out	evado
Astyanax	Astyanax
grandfather	avus
father_in_law	socer
unattended	incomitatus
wife_of_Hector	Andromache
Andromache	Andromache
use	usus
free	pervius
unobstructed	pervius
perform	instauro
build	instauro
throw	devolvo
roll_down	devolvo
the_end	ultima
tower	turris
grasp	prenso
protect	protego
conceal	protego
cover	protego
the_left_hand	sinistra
door	postis
doorjamb	postis
scaling_ladder	scalae
ladder	scalae
wall	paries
wild	indomitus
untamed	indomitus
nowhere	nusquam
at_once	protinus
age	aevum
lifetime	aevum
eternity	aevum
Pelias	Pelias
Iphitus	Iphitus
succession	vicis
change	vicis
turn	vicis
shun	vito
avoid	vito
my_kindred	mei
foreign	exter
outward	exter
ashes	cinis
bandage	infula
transfix	configo
fasten_together_or_firmly	configo
right	aequum
that_which_is_even	aequum
observant	servans
fall_prostrate	procumbo
sink_down	procumbo
fall_forwards	procumbo
powerful_in_arms	armipotens
Peneleus	Peneleus
immediately	ilicet
mark	signo
disagreeing	discors
sound	sonus
lie	mentior
drive	agito
foundation	fundus
Nereus	Nereus
frothy	spumeus
foamy	spumeus
make_shrill_noise	strido
strike_together_violently	confligo
army	exercitus
our_friends	nostri
rush_upon	incurro
run_inor_against	incurro
attain	consequor
overtake	consequor
perish	pereo
lay_hands_on	inicio
throw	inicio
madden	furio
specter	species
image	species
appearance	species
tender	tener
of_Priam	Priameius
believe	fido
trust	fido
unwilling	invitus
back	rursus
ugly	turpis
Orcus	Orcus
join	consero
tie_together	consero

mingle_with	immisceo
arm	armo
equip	armo
fit_one_thing_another	accommodo
hairy	comans
decoration	insigne
medal	insigne
on_the_right_side	dexter
right	dexter
exult	exsulto
ecstatic	exsulto
good_fortune	successus
going_up	successus
fear	formido
dense	densus
thick	densus
rush_in	inruo
the_contrary	secus
not_so	secus
differently	secus
otherwise	secus
dark_blue	caerulus
agitated	trepidus
press/lean_upon	nitor
thorn	sentis
restrain	reprimo
glide	delabor
response	responsum
an_answer	responsum
sloth	segnities
_late	serus
hurry	festino
allied	socius
Androgeos	Androgeos
the_heart	praecordia
the_vital_parts	praecordia
the_diaphragm_or_midriff	praecordia
superstitious	religiosus
reverent	religiosus
here_and_there	passim
lazy	iners
unskilled	iners
explain	explico
untangle	explico
destruction	clades
hover_round	circumvolo
fly_around_or_surround_in_flying	circumvolo
go	vado
dry	siccus
mouth	faux
young_animal	catulus
belly	venter
stomach	venter
plunderer	raptor
just_as	ceu
as	ceu
wolf	lupus
craving	cupido
desire	cupido
crowded_together	confertus
rule	praeceptum
precept	praeceptum
the_betrothed	sponsa
one_promised_as_bride	sponsa
son_in_law	gener
insane	insanus
Mygdonides	Mygdonides
Coroebus	Coroebus
young	iuvenis
youthful	iuvenis
gather	agglomero
Dymas	Dymas
Hypanis	Hypanis
Epytus	Epytus
Ripheus	Ripheus
murmuring	fremitus
Erinys	Erinys
battle	proelium
sharp_point_or_edge	mucro
narrow	angustus
blockade	obsideo
as_many_as	quot
how_many	quot
with_double_doors	bipatens
leap_upon	insulto
armed_men	armati
difficult	arduus
steep	arduus
fierce	ferus
wild	ferus
that_can_not_averted_by_struggling	ineluctabilis
snatch	prehendo
grasp	prehendo
lay_hold_of	prehendo
Othryades	Othryades
Panthus	Panthus
die	morior
method	ratio
insane	amens
mad	amens
trumpet	tuba
braying	clangor
clashing_sound	clangor
proceed	exorior
rise_up	exorior
shine_back_or_again	reluceo
pertaining_Sigeum	Sigeus
Ucalegon	Ucalegon
Vulcan	Vulcanus
Deiphobus	Deiphobus
open_view	patesco
begin_open	patesco
manifest	manifestus
clear	manifestus
headlong	praeceps
ox	bos
grain	sata
things_sown_or_planted	sata
torrent	torrens
rushing_stream	torrens
pertaining_the_mountains	montanus
fall_in/on	incido
standing_corn	seges
field_of_grain	seges
climbing_or_ascending	ascensus

roughening_or_bristling	horror
advance_furiously	ingruo
rush_into	ingruo
grow_loud	claresco
become_clear_the_ear_or_eye	claresco
withdraw	recedo
cover_up_or_over	obtego
secret	secretus
hidden	secretus
separated	secretus
innermost	penetralis
wander_through_or_over	pererro
approve	commendo
recommend	commendo
entrust	commendo
top	culmen
nothing	nihil
calm	serenus
serene	serenus
unworthy	indignus
expect	exspecto
wait_for	exspecto
Dardania	Dardania
explain	expromo
bring_forth	expromo
cry	fleo
stiffen	concresco
grow_thick	concresco
grow_together	concresco
beard	barba
rough	squaleo
garment	exuviae
that_which_has_been_taken_off	exuviae
go_back	redeo
how_much	quantum
woe_alas	ei
puff_up	tumeo
swell	tumeo
car	bigae
car_or_chariot_drawn_by_two_horses	bigae
team_of_two_horses	bigae
weeping	fletus
creep	serpo
sleepless	vigil
on_watch	vigil
bury	sepelio
go_in	invado
Epeius	Epeos
constructor	fabricator
Menelaus	Menelaus
Machaon	Machaon
Neoptolemus	Neoptolemus
Pelides	Pelides
Thoas	Thoas
Acamas	Acamas
Sthenelus	Sthenelus
Thessandrus	Thessandrus
take	promo
reveal	patefacio
spread_out	laxo
pine_growing	pineus
of_pine	pineus
uneven	iniquus
ward_off	defendo
defend	defendo
battalion	phalanx
body_of_troops_in_compact_array	phalanx
sound	sopor
sleep	sopor
cast_upon	involvo
roll_on_or_in	involvo
leaf	frons
cover	velo
festive	festus
sacred	festus
farthest	ulterior
farther	ulterior
command	iussus
order	iussus
Cassandra	Cassandra
set_up	sisto
forgetful	immemor
unmindful	immemor
halt	subsisto
stand_after	subsisto
fall	illabor
glide	illabor
line	funis
rope	funis
girl	puella
climb	scando
strain	intendo
stretch	intendo
made_of_tow_or_flax	stuppeus
shout	conclamo
turn_or_hurl_toward	intorqueo
criminal	sceleratus
serve_as_soldier	mereo
deserve	mereo
earn	mereo

weigh_out	expendo
trembling	pavor
fear	pavor
penetrate	insinuo
embosom	insinuo
shake	tremefacio
cause_tremble_or_quake	tremefacio
round_shield	clipeus
_Pallas_or_Minerva	Tritonis
of_Lake_Triton	Tritonis
escape	effugio
flee	effugio
dragon_or_fabulous_kind_of_serpent	draco
shrine	delubrum
the_place_for_sacrificial_cleansings	delubrum
gliding	lapsus
slipping	lapsus
axe	securis
drunk	saucius
afflicted	saucius
wounded	saucius
bellowing	mugitus
lowing	mugitus
dreadful	horrendus
shuddered_at	horrendus
putrid	sanies
wash	perfundo
pour_over_or_along	perfundo
tear_in_pieces	divello
tear_asunder	divello
scaly	squameus
bind	ligo
tie	ligo
fold	spira
consume	depascor
embrace	amplector
snake	serpens
creeping_thing	serpens
2	duo
without_blood	exsanguis
sight	visus
run_away	diffugio
flee_apart	diffugio
shake	vibro
language	lingua
tongue	lingua
lick	lambo
hissing	sibilus
suffuse	sufficio
noise	sonitus
sounding	sonitus
roll	volumen
book	volumen
coil	sinuo
make_infold_or_folds	sinuo
after_	pone
behind	pone
the_rest	ceterus
the_other	ceterus
bloodshot	sanguineus
bloody	sanguineus
of_serpent	iuba
the_mane_of_horse	iuba
snake	anguis
bristle	horresco
become_rough	horresco
still	tranquillus
calm	tranquillus
kill	macto
reward	macto
punish	macto
customary	sollemnis
not_looking_before	improvidus
throw_in_the_way	obiicio
dreadful	tremendus
trembled_at	tremendus
greatly	multo
by_much	multo
10th	decem
10	decem
dominate	domo
subdue	domo
Larissaean	Larisaeus
of_Lariss	Larisaeus
lie	periurium
false_oath	periurium
descendant	nepos
grandchild	nepos
Greek	Pelopeus
Argive	Pelopeus
Pelopeian	Pelopeus
of_Pelops	Pelopeus
rather	prius
to	prius
in_preference	prius
before	prius
preceding	prius
earlier	prius
violate	violo
form	texo
build_cunningly	texo
weave	texo
strength	robur
oak	robur
immense	immensus
divinely_forbidden	nefas
advise	moneo
warn	moneo
arrange	digero
separate	digero
measure_again	remetior
tear_down	exscindo
tear_out	exscindo
small_round_shield_or_buckler	parma
shine	emico
leap	emico
sweat	sudor
statue	simulacrum
likeness	simulacrum
monster	monstrum
omen	monstrum
an_epithet_of_Pallas	Tritonius
Tritonian	Tritonius
slip_or_glide_beneath	sublabor
backwards	retro
of_virgin	virgineus
maidenly	virgineus
effigy	effigies
image	effigies
portrait	effigies
holy	sacer
an_image_of_Pallas	Palladium
Palladium	Palladium
pluck	avello
approach	adgredior
fatal	fatalis
fated	fatalis
contriver	inventor
finder	inventor
promise	promissum
cover	tego
hate	odi
untie	resolvo
sword	ensis
testify	testor
inviolable	violabilis
violable	violabilis
scruple	religio
rite	religio
founder	auctor
ask	rogo
set_forth	edissero
state	edissero
forget	obliviscor
so	ita
in_this_way	ita

long_sleeve	manicae
sleeve_reaching_the_hand	manicae
something_connected_with_the_hand	manicae
feel_pity	miseresco
pity	misereor
chaste	intemeratus
undefiled	intemeratus
truth	verum
that_which_is_true	verum
because	quod
atone_for	pio
blame	culpa
fault	culpa

fleeing_away	effugium
ask_again	reposco
perchance	fors
haply	fors
wish_exceedingly	exopto
choose_out	exopto
lurk	delitesco
hide	delitesco
water_grass	ulva
reservoir	lacus
lake	lacus
miry	limosus
full_of_mud	limosus
death	letum
ribbon	vitta
temple	tempus
the_side_of_the_forehead	tempus
witty	salsus
salted	salsus
_rite	sacrum
holy_thing	sacrum
ruin	exitium
destruction	exitium
every	quisque
each	quisque
and	adsentio
intend	destino
determine	destino
break	rumpo
compact	compositum
an_agreement	compositum
place_opposite	oppono
refuse	recuso
covered	tectus
5_each	quini
that_which_is_come	venturum

demand	flagito
draw	protraho
confusion	tumultus
poet	vates
Apollo	Apollo
tremor	tremor
quaking	tremor
trembling	tremor
icy	gelidus
cold	gelidus
atone	lito
sacrifice_auspiciously	lito
cut	caedo
strike	caedo
kill	caedo
carry_back	reporto
the_inaccessible	adytum
prophecy	oraculum
oracle	oraculum
Eurypylus	Eurypylus
of_maple	acernus
construct	contexo
weave_together	contexo
hinder	intercludo
close_the_way	intercludo
depart	discedo
go_away	discedo
desire	cupio
feigned	fictus
tremble	pavito
much_agitated	pavito
follow	prosequor
inquire	scitor
ascertain	scitor
seek_know	scitor
Ithacan	Ithacus
of_Ithaca	Ithacus
consume	sumo
take_up	sumo
enough	satis
roll_back	revolvo
unpleasant	ingratus
in_vain	nequiquam
moreover	autem
however	autem
Calchas	Calchas
rest	requiesco
falling	labes
punisher	ultor
avenger	ultor
go_back	remeo
ever	umquam
raving	demens
mad	demens
silent	taceo
darkness	tenebrae
life	vita
concede	concedo
allow	concedo
withdraw	concedo
deceitful	pellax
leading_error	pellax
jealousy	invidia
envy	invidia
assembly	concilium
union	concilium
flourish	vigeo
uninjured	incolumis
humble	pauper
poor	pauper
related	propinquus
near	propinquus
kinship	consanguinitas
companion	comes
grieve	lugeo
mourn	lugeo
futile	cassus
void	cassus
murder	nex
killing	nex
because	quia
evidence	indicium
information	indicium
innocent	insons
of_the_sea	pelagius
abandonment	proditio
betrayal	proditio
glory	gloria
renown	gloria
glorious	inclutus
famous	inclutus
Palamedes	Palamedes
Belides	Belides
arrive_at	pervenio
reach	pervenio
bad	improbus
deceitful	mendax
false	mendax
invent	fingo
shape	fingo
Sinon	Sinon
refuse	nego
deny	nego
admit	fateor
confess	fateor
increase	cresco
grow	cresco
attack	impetus
compress	comprimo
angry	infensus
hostile	infensus
in_the_presence_of	apud
near	apud
finally	denique
alas_oh	heu
survey	circumspicio
cast_glance_round_upon	circumspicio
look_around	circumspicio
accusation	crimen
verdict	crimen


play_upon	inludo
look_at	viso
from_all_sides	undique
each_of_two	uterque
bold	fidens
trusting	fidens
voluntarily	ultro
beyond	ultro
furthermore	ultro
shepherd	pastor
bind_back	revincio
behold	ecce
defile	foedo
Greek	Argolicus
Argolic	Argolicus
of_Argolis	Argolicus
on_the_left_side	laevus
left	laevus
resound	insono
sound_within	insono

cause_resound	recutio
strike_back	recutio
turn_round_entirely	contorqueo
the_abdomen	alvus
curved	curvus
wild_animal	ferus
look_inor_overlook	inspicio
machine	machina
construct	fabrico
conceal	occulto
hide	occulto
firewood	lignum
without	careo
think	puto
citizen	civis
madness	insania
run_down	decurro
Laocoon	Laocoon
then	ibi
there	ibi
uncertain	incertus
concealment	latebra
hiding_place	latebra
pierce	terebro
bore_through	terebro
put_up_for_auction	subicio
throw_under	subicio
suspicious	suspectus
urge	hortor
within	intra
Thymoetes	Thymoetes
Minerva	Minerva
fatal	exitialis
destructive	exitialis
not_veiled	innuptus
abandon	relinquo
abandon	desero
leave	desero
Doricus	Doricus
Teucria	Teucria
think	reor
abandoned	desertus
desolate	desertus

carry_forward_or_forth	proveho
ship	carina
keel	carina
badly	male
standing	statio
Tenedos	Tenedos
fill_up	compleo
armed	armatus
the_womb	uterus
cavern	caverna
hollow	caverna
enclose	includo
stealthily	furtim
obtain	sortior
cast_lots	sortior
choose	deligo
choose_from	deligo
wander_about	vagor
revenue	reditus
return	reditus
fir_tree	abies
work_in	intexo
weave_inor_in	intexo
establish	aedifico
erect	aedifico
build	aedifico

just_like	instar
the_equivalent	instar
drive_back	repello
run_away	refugio
flee_back	refugio
grief	luctus
mourning	luctus
dread	horreo
although	quamquam
throw_down	praecipito
damp	umidus
moist	umidus
Ulysses	Ulixes
soldier	miles
Dolopes	Dolopes
Myrmidones	Myrmidones
dig_up	eruo
unearth	eruo
cast_out_or_up	eruo
deplorable	lamentabilis
renew	renovo
refresh	renovo
restore	renovo
earnestly_attentive	intentus
still	conticesco
become_still	conticesco
error	error
wandering	error
ambush	insidiae
no_indeed	immo
Diomedes	Diomedes
aurora	aurora
dawn	aurora
ask_frequently	rogito
clapping	plausus
beating	plausus
repeat	ingemino
stand_in_the_way	obsto
stand_before	obsto
slow	tardus
_winter	hibernus
color	tingo
dye	tingo
moisten	tingo
wet	tingo
hasten	propero
only	tantum
an_ox_as_the_breaker_of_the_sod_in_plowing	trio
the_Hyades	Hyades
bringing_rain	pluvius
rainy	pluvius
Arcturus	Arcturus
an_animal	pecus
one_animal_of_flock_or_herd	pecus
moon	luna
Atlas	Atlans
gild	auro
sing	persono
sound_loudly	persono
Iopas	Iopas
long_haired	crinitus
the_cithara	cithara
elder	procer
chief	procer
aristocrat	procer
nobleman	procer
wash_forth_or_out	proluo
swallow	haurio
drink	haurio
drain	haurio
not_inactive	impiger
not_sluggish	impiger
make_great_noise	increpito
Bitias	Bitias
touch	attingo
as_far_as	tenus
favor	faveo
celebrate	celebro
frequent	celebro
giver	dator
host	hospes
stranger	hospes
guest	hospes
silence	silentium
accustomed	soleo
saucer_shaped_dish	patera
wine_unmixed_with_water	merum
wine	merum
pertaining_rope_or_cord	funalis
paneled_or_fretted_ceiling	laquear
ceiling_with_hollows_or_panels	laquear
lamp	lychnus
hang	dependeo
hang_down	dependeo
court	atrium
atrium	atrium
become	fio
surround	corono
crown	corono
large_mixing_bowl	crater

become_unaccustomed	desuesco
seated	reses
some_time_before_or_since	iampridem
try	tento
begin	incipio
cause_wane_or_waste	aboleo
abolish	aboleo
gradually	paulatim
pertaining_Venus	Acidalius
Acidalian	Acidalius
sink	insido
unaware	inscius
not_knowing	inscius
sometimes	interdum
embrace	complexus

begin_burn	ardesco
unable	nequeo
dedicate	devoveo
plague	pestis
paint	pingo
word	verbum
burn	flagro
embroidered	pictus
swelling	torum
cushion	torum
couch	torum
bed	torum
often	frequens
and_in_fact	necnon
and_yet	necnon
and_also	necnon
drinking_cup	poculum
servant	minister
attendant	minister
like	pār
equal	pār
just_as_many	totidem
cause_increase	adoleo
construct	struo
victuals	penus
provision	penus
store_of_food	penus
maidservant	famula
female_house_slave	famula
50th	quinquaginta
50	quinquaginta
shaggy_hair	villus
handcloth	mantele
finish	tondeo
shear	tondeo
baskets	canistra
basket	canistra
water	lympha
clear_spring_water	lympha
house_slave	famulus
recline_at_table	discumbo
recline_separately	discumbo
couch	sponda
the_frame_of_bedstead_or_couch	sponda
curtain	aulaeum
embrace	complector
breathe_or_upon	aspiro
flower	flos
marjoram	amaracus
gentle	mollis
yielding	mollis
Idalia	Idalia

water	inrigo
rest	quies
sleep	quies
glad	gaudeo
strip	exuo
take_off	exuo
poison	venenum
inspire	inspiro
breathe_into	inspiro
secret	occultus
hidden	occultus
an_embrace	amplexus
Lyaeus	Lyaeus
wine	latex
liquor	latex
liquid	latex
bosom	gremium
lap	gremium
clothe	induo
put_on	induo
deceive	fallo
generous	amplus
ample	amplus
large	amplus
spacious	amplus
come_mind	occurro
run_meet	occurro
put_back	recondo
holy	sacratus
Idalium	Idalium
Cyther	Cythera
lull_sleep	sopio
put_sleep	sopio
summons	accitus
rehearse	meditor
think	meditor
for_which_reason	quocirca
cease	cesso
pertaining_Juno	Iunonius
fear	vereor
delay	moror
pleasant	blandus
flattering	blandus
Phoenissus	Phoenissus
know	nosco
learn	nosco
bitter	acerbus
flee	confugio
Typhoian	Typhoeus
pertaining_the_giant_Typhoeus	Typhoeus
power	potentia
address	adfor
speak_to	adfor
winged	aliger
wing_bearing	aliger
therefore	ergo
come_back	recurso
rush_back	recurso
cruel	atrox
terrible	atrox
burn	uro
double_tongued	bilinguis
doubtful	ambiguus
uncertain	ambiguus
fear	timeo
involve	implico
fold_in	implico
bone	os
burn	incendo
set_fire_to	incendo
Cupid	Cupido
change	muto
face	facies
appearance	facies
keep_turning	verso
crown	corona
garland	corona
gem	gemma
jewel	gemma
studded_with_pearls	bacatus
necklace	monile
neck	collum
Ilione_or_Iliona	Ilione
Leda	Leda
carry_out_or_away	effero
marriage	hymenaeus
not_allowed	inconcessus
Helen	Helena
an_equipping	ornatus
the_plant_bear's_foot	acanthus
garment	velamen
covering	velamen
saffron_colored	croceus
of_saffron	croceus
woven_round	circumtextus
stiffen	rigeo
stiff	rigeo
cloak	palla
send_ahead	praemitto
chain_of_things	series
carve	caelo
cut_in_relief	caelo
purple_dye	ostrum
the_purple_fluid_of_the_murex	ostrum
work	laboro
talent	ars
skill	ars
feast	convivium
banquet	convivium
arrange	instruo
furnish	instruo
build_upon	instruo
excess	luxus
splendid	splendidus
brilliant	splendidus
clear	splendidus
shining	splendidus
kingly	regalis
regal	regalis
public_show	munus
duty	munus
gift	munus
lamb	agnus
pig	sus
bull	taurus
20th	viginti
20	viginti
too_little	parum
announce	indico
proclaim	indico
learn	disco
come_mind	succurro
finally	demum
follow	succedo
come_on_Let's_go	age
therefore	quare
why	quare
family_tree	stirps
stalk	stirps
stem	stirps
born	orior
rise	orior
Greek	Pelasgus
Pelasgian	Pelasgus
inquire	cognosco
understand	cognosco
learn	cognosco
Cyprus	Cyprus
fertile	opimus
rich	opimus
Belus	Belus
paternal	patrius
expel	expello
drive_out	expello
propel	expello
Sidon	Sidon
Anchises	Anchises
place_to/near	applico
apply_to	applico
danger	periculum
speak	loquor
sight	aspectus
Serestus	Serestus
the_left_hand	laeva
always	semper
run	curro
river	fluvius
right	rectum
conscious	conscius
anywhere	usquam
look_round	respecto
scatter	spargo
everywhere	ubique
worthy	dignus
pay	persolvo
free_one's_self_from_obligation	persolvo
set_free	persolvo
loosen_completely	persolvo
thanks	grates
share	socio
make_one_socius	socio
in_want	egenus
needy	egenus
exhaust	exhaurio
drain	exhaurio
feel_or_show_pity	miseror
only	solus
alone	solus
unforeseen	improvisus
stone	lapis
of_Paros	Parius
yellow	flavus
golden	flavus
ivory	ebur
breathe_upon	adflo
blow_upon	adflo
youth	iuventa
mother	genetrix
she_who_brings_forth	genetrix
the_hair_of_the_head	caesaries
handsome	decorus
suitable	decorus
fitting	decorus
oppose	resisto
stand_still	resisto
clean	purgo
suddenly	repente
the_other	ceterus
answer	respondeo
absent	absum
away	absum
address	compello
burst_out	erumpo
break_out	erumpo
now_for_long_time	iamdudum
expel	eicio
throw_out	eicio
present	adsum
drive	compello
introduces_an_Optative_subjunctive	utinam
of_or_belonging_Troy	Tros
Trojan	Tros
set_up	statuo
settle	consido
sit_down	consido
alike	pariter
send_away	dimitto
Eryx	Eryx
such_an_extent	adeo
such_point	adeo
so	adeo
enfeebled	obtusus
fire	incendium
courage	virtus
manliness	virtus
not_know	nescio
look_at	tueor
guardian	custos
newness	novitas
harsh	durus
hard	durus
shut_apart	secludo
speak	profor
say	profor
speak_out	profor
Dardanides	Dardanides
carry_or_convey_to	adveho
at_any_rate	saltem
at_least	saltem
Sicania	Sicania
channel	fretum
straight	fretum
resist	resto
consume	absumo
reduce	absumo
but_if	sin

draw_(from_scabbard	stringo
bind_fast	stringo
draw_tight	stringo
join	apto
fit_together	apto
prepare	apto
adapt_to	apto
take_away	subduco
remove	subduco
raise	subduco
draw_up	subduco
_although	licet
it_is_permitted	licet
shake_violently	quasso
cause_repent	paenitet
make_sorry	paenitet
compete	certo
fight	certo
duty	officium
service	officium
lie	occubo
still	adhuc
this_point	adhuc
thus_far	adhuc
feed_on	vescor
eat	vescor
other_of_two	alter
unutterable	nefandus
not_spoken	nefandus
lawful	fandus
proper	fandus
speakable	fandus
despise	temno
human	humanus
cause	cieo
permit	permitto
savage	barbarus
barbarous	barbarus
foreign	barbarus
so	tam
swim_up_to	anno
_small	paucus
_few	paucus
trackless	invius
without_way	invius
the_open_sea	salum
the_tossing_or_heaving_swell_of_the_sea	salum
insolent	procax
bold	procax
Orion	Orion
rainy	nimbosus
stormy	nimbosus
rise	adsurgo
rise_up	adsurgo
small	parvus
of_Oenotria	Oenotrius
soil	glaeba
clod	glaeba
lump_of_earth	glaeba
udder	uber
Hesperia	Hesperia
pride	superbia
plunder	populo
prevent	prohibeo
righteousness	iustitia
begin	coepi
troops	copia
abundance	copia
publicly	coram
openly	coram
_personally	coram
enter	introgredior
go_within	introgredior
pardon	venia
plead	oro
pray	oro
relinquish	linquo
leave	linquo
surround	amicio
clothe	amicio
cover	amicio
watch	speculor
dissemble	dissimulo
conceal	dissimulo
unperceived	incognitus
unnoticed	incognitus
unknown	incognitus
join_together	coniungo
happiness	laetitia
joy	laetitia
kill	percutio
strike	percutio
astonished	obstipesco
become_stupefied	obstipesco
bear_away	aveho
carry_off	aveho
separate	dispello
drive_away	dispello
Sergestus	Sergestus
crowd	concursus
concourse	concursus
fair	iustus
just	iustus
law	lex
shrink	resido
sink_down	resido
sit_down	resido
elated_by_	subnixus
relying_on	subnixus
seat	solium
vaulted_roof	testudo
tortoise	testudo
joy	gaudium
test	pertempto
handle_completely	pertempto
silent	tacitus
Latona	Latona
rise_above	superemineo
Oreas	Oreas
form_inball	glomero
company_of_singers_or_dancers	chorus
dance	chorus
dance_in_circle	chorus
Dian	Diana
Cynthus	Cynthus
chain_of_hills	iugum
ridge	iugum
yoke	iugum
bank	ripa
Eurotas_River	Eurotas
crowd	caterva
band	caterva
look	obtutus
looking_at	obtutus
bewildered	stupeo
amazed_or_dazed	stupeo
wonderful	mirandus
wondered_at	mirandus
Trojan	Dardanus
Dardanian	Dardanus
assemble	concurro

female_warrior	bellatrix
momma	mamma
the_breast	mamma
girdle	cingulum
expose	exsero
thrust_out	exsero
bind_under	subnecto
tie_beneath	subnecto
golden	aureus
glow	ardeo
burn	ardeo
1000th	mille
1000	mille
Penthesilea	Penthesilea
light_crescent_shaped_shield	pelta
bend_like_halfmoon	luno
Amazonis	Amazonis
Memnon	Memnon
wicked	niger
unlucky	niger
black	niger
line_of_battle	acies
edge	acies
eastern	Eous
belonging_the_dawn	Eous
mix_completely	permisceo
first	princeps
chief	princeps
unarmed	inermis
friendly	amicus
groan	gemitus
groaning	gemitus
certainly	vero
sell	vendo
lifeless	exanimus
breathless	exanimus
drag	rapto
seize_violently	rapto
from_behind	aversus
turned_away	aversus
beat	tundo
robe	peplum
mantle	peplum
explain	pando
spread_out	pando

daughter_of_Ilium_or_Troy	Ilias
hair	crinis
equal	aequus
spear	hasta
write_on	inscribo
dust	pulvis
bent_back	resupinus
hang_on_to	haereo
stick_to	haereo
engage	congredior
meet	congredior
in_unequal_combat	impar
unequal	impar
unhappy	infelix
unfortunate	infelix
Troilus	Troilus
drink	bibo
The_Xanthus_or_Scamander	Xanthus
taste	gusto
food	pabulum
feeding_material	pabulum
camp	castra
killing	caedes
lay_waste	vasto
tent	tentorium
snowy	niveus
Rhesus	Rhesus
at_distance	procul
plumed	cristatus
crested	cristatus
Phryges	Phryges
young_man	iuventus
youth	iuventus
of_Greece	Graecus
Greek	Graecus
by_this_way_or_route	hac
Pergamum	Pergama
wage_war	bello
river	flumen
moisten	umecto
ample	largus
void	inanis
empty	inanis
feed	pasco
painting	pictura
the_art_of_painting	pictura
any	aliquis
some	aliquis
something	aliquis
someone	aliquis
touch	tango
fortunes	mortalia
human_affairs	mortalia
glory	laus
praise	laus
reward	praemium
look	en
region	regio
weep	lacrimo
cry	lacrimo
both	ambo
Priamus	Priamus
son_of_Atreus	Atrides
circulate	vulgo
publish	vulgo
fight	pugna
battle	pugna
an_artist	artifex
expect	opperior
wait	opperior
separate	singuli
review	lustro
survey	lustro
purify_by_atonement	lustro
trust	confido
assured	confido
well	bene
dejected	adflictus
health	salus
hope	spero
alleviate	lenio
present	offero
offer	offero
hinge	cardo
door	foris
beam_of_wood	trabs
weave	necto
connect	necto
bind	necto
tie	necto
position	gradus
step	gradus
made_of_copper_or_bronze	aereus
goddess	diva
opulent	opulentus
rich	opulentus
gift	donum
Sidonian	Sidonius
of_Sidon	Sidonius
easy	facilis
uncommon	egregius
distinguished	egregius
royal	regius
sign	signum
impression	signum
mark	signum
wood	lucus
grove	lucus
extraordinary	mirabilis
wonderful	mirabilis
accept	suspicio
recognize	suspicio
take_up	suspicio
happy	fortunatus
fortunate	fortunatus
lucky	fortunatus
fragrant	fragro
emit_smell	fragro
the_herb_thyme	thymum
redolent_of	redoleo
give_forth_smell	redoleo

boil	ferveo
trough	praesaepe
manger	praesaepe
an_enclosure	praesaepe
herd	pecus
farm_animals	pecus
drone	fucus
the_male_bee	fucus
lazy	ignavus
burden	onus
load	onus
room	cella
nectar	nectar
extend	distendo
stretch_apart_or_out	distendo
tread_down	stipo
honey	mel
fluid	liqueo
the_new_swarm	fetus
the_young	fetus
bearing_or_breeding	fetus
lead_forth	educo
mature	adultus
ripe	adultus
carry_on	exerceo
exercise	exerceo
train	exerceo
country	rus
flowery	floreus
bee	apis
glory	decus
ornament	decus
beauty	decus
cut_out	excido
column	columna
foundation	fundamentum
theater	theatrum
dig_out	effodio
senate	senatus
consecrated	sanctus
read	lego
collect	lego
choose	lego
magistracy	magistratus
furrow	sulcus
shut_around	concludo
shut_completely	concludo
roof	tectum
roll_up	subvolvo
wall	murus
burning	ardens
stand_in/on	insto
_bed	stratum
coverlet	stratum
bedding	stratum
din	strepitus
an_uproar	strepitus
noise	strepitus
huts	magalia
astonished	miror
wonder	miror
look_at_or_upon	aspecto
hill	collis
ascend	ascendo
lane	semita
fragrant_or_redolent	halo
exhale_or_emit_odor	halo
breathe	halo
fresh	recens
garlands	serta
things_entwined	serta
glow	caleo
warm	caleo
incense	tus
Arabian	Sabaeus
Sabaean	Sabaeus
temple	templum
visit_again	reviso
look_at_again	reviso
Paphos	Paphos
demand	posco
delay	mora
devise	molior
work_at	molior
neither	neu
nor	neu
and_not	neu
or_not	neu
an_upper_garment	amictus
veiling_or_draping_of_the_person	amictus
encompass	circumfundo
pour_around	circumfundo
cloud	nebula
enclose	saepio
fence_in	saepio
dark	obscurus
covered	obscurus
accuse	incuso
bring_cause_or_case_against_any_one	incuso
return	reddo
why	cur
false	falsus
deceptive	falsus
so_often	totiens
son	natus
recognize	agnosco
walk	incessus
manner_of_walking	incessus
walking_or_advancing	incessus
true	verus
real	verus
sail_down	defluo
flow_down	defluo
clothing	vestis
foot	pes
breathe	spiro
scent	odor
divine	divinus
ambrosial	ambrosius
shine_forth	refulgeo
flash_back	refulgeo
neck	cervix
rosy	roseus
step	gressus
stepping	gressus
lay_straight	dirigo
full	plenus
the_groin	pubes
differently	aliter
otherwise	aliter
song	cantus
melody	cantus
singing_or_playing	cantus
sexual_union	coitus
meeting_together	coitus
look_down_upon	despecto
seize	capio
row	ordo
disturb	turbo
bird	ales
zone	plaga
tract	plaga
heavenly	aetherius
swan	cycnus
glad	laetor
rejoice	laetor
6_at_time	senus
look_at	aspicio
prophecy	augurium
in_vain	frustra
safety	tutum
announce	nuntio
brought_back	redux
led_back	redux
endure	perfero
threshold	limen
just_now	modo
only	modo
arrive	advenio
criticize	carpo
seize	carpo
pluck	carpo
pertaining_life	vitalis
vital	vitalis
god_or_goddess	caelestis
whichever	quisquis
whoever	quisquis
interrupt	interfor
speak_between	interfor
complain	queror
strike	pello
drive	pello
Asia	Asia
Europ	Europa
roam	peragro
go_through_fields_or_lands	peragro
wastes	deserta
desert_places	deserta
destitute	egens
left_over	supersum
pluck	convello
pull_violently	convello
10_each	deni
well_known	notus
_enemy	hostis
bring	appello
drive_to	appello
luck	fors
chance	fors
Olympus	Olympus
the_evening_start	Vesper
Vesper	Vesper
an_annual_chronicle	Annalis
empty	vaco
proceed	pergo
demand_back	repeto
drag	traho
sigh	suspiro
breathe_from_beneath_or_deeply	suspiro
journey	iter
in_order_that	quo
what_purpose	quo
where	quo
surround	circumdo
how_great	quantus
of_bull	taurinus
Byrsa	Byrsa
native_territory	solum
bottom	solum
traffic	mercor
exchange_merchandise	mercor
rise	surgo
arrive_at	devenio
come_down	devenio
wife	femina
woman	femina
general	dux
leader	dux
greedy	avarus
tyrant	tyrannus
hatred	odium
agree	convenio
assemble	convenio
weight	pondus
silver	argentum
unknown	ignotus
treasure	thesaurus
open	recludo
unclose	recludo
street	via
help	auxilium
aid	auxilium
recommend	suadeo
go_out/away	excedo
speed	celero
reveal	retego
uncover	retego
cross_over	traicio
pierce	traicio
transport	traicio
wonderful	mirus
marvelous	mirus
ghastly	pallidus
pale	pallidus
raise_up	attollo
manner	modus
measure	modus
echo	imago
image	imago
unburied	inhumatus
sleep	somnus
_lover	amans
fond	amans
loving	amans
play_with	ludo
play	ludo
empty	vanus
evil	malus
bad	malus
hide	celo
for_long_time	diu
deed	factum
real	germanus
true	germanus
having_the_same_parents	germanus
unsuspecting	incautus
unguarded	incautus
secretly	clam
blind	caecus
gold	aurum
crime	scelus
Pygmalion	Pygmalion
hold	habeo
have	habeo
Tyre	Tyros
omen	omen

yoke	iugo
unbroken	intactus
untouched	intactus
love	diligo
choose	diligo
pitiable	miser
wretched	miser
Phoenices	Phoenices
field	ager
Sychaeus	Sychaeus
summit	fastigium
meandering	ambages
circuitous_route	ambages
roundabout_path	ambages
escape	fugio
flee	fugio
brother	germanus
set_forth	proficiscor
that_can_not_handled_or_managed	intractabilis
Libyan	Libycus
Agenor	Agenor
Carthaginian	Punicus
Punic	Punicus
buskin	cothurnus
the_leg	sura
the_calf_of_the_leg	sura
on_high	alte
aloft	alte
purple	purpureus
bear	gesto
carry	gesto
deem_worthy_of	dignor
victim	hostia
sacrificial_animal	hostia
teach	doceo
finally	tandem
ours	noster
our	noster
fortunate	felix
Phoebus	Phoebus
if	an
whether	an
or	an
sound	sono
mortal	mortalis
by_no_means	haud
not_at_all	haud
begin	ordior
son	filius
wild_boar	aper
foam	spumo
lynx	lynx
speckled	maculosus
spotted	maculosus
quiver	pharetra
wrap	succingo
gird_up	succingo
gird_beneath	succingo
point_out	monstro
show	monstro
youth	iuvenis
say	inquam
hi_hey	heus
_superior_to	prior
first	prior
prior	prior
previous	prior
former	prior
flow	fluo
knee	genu
bare	nudus
nude	nudus
pour_round_about	diffundo
hair	coma
huntress	venatrix
hang	suspendo
suited	habilis
shoulder	umerus
the_upper_arm	umerus
Hebrus	Hebrus
preoccupy	praeverto
turn_before	praeverto
flying	volucer
Harpalyce	Harpalyce
Thracian_huntress	Threissa
what_sort	qualis
or	vel
Spartan	Spartanus
style_of_dress	habitus
appearance	habitus
condition	habitus
maiden	virgo
in_the_way	obvius
mother	mater
spear	hastile
the_shaft_of_spear	hastile
brandish	crispo
wrinkle	crispo
2_by_2	bini
accompany	comitor
walk	gradior
step	gradior
cover	occulo
tree	arbor
hollow_or_scoop_out	cavo
recess	convexum
convexity	convexum
scrupulous	exactus
precise	exactus
decide	constituo
establish	constituo
seek	quaero
wild_animal	fera
unshorn	incultus
neglected	incultus
uncared_for	incultus
for	nam
go_forth	exeo
blessed	almus
giving_nourishment	almus
daylight	lux
kind	benignus
especially	imprimis
wish	volo
Carthaginian	Poenus
Phoenician	Poenus
swift	citus
armpit	ala
wing	ala
oarage	remigium
rowing	remigium
air	aer
Dido	Dido
ignorant	nescius
that	ne
that…not	ne
in_order_that…not	ne
not	ne
hospitality	hospitium
open	pateo
new	novus
bring_forth	gigno
Maia	Maia
blood_stained	cruentus
bloody	cruentus
uncouth	horridus
rough	horridus
knot	nodus
brazen	aenus
of_bronze	aenus
tie_up	vincio
disloyal	impius
narrow	artus
straitened	artus
iron	ferrum
ill_omened	dirus
awful	dirus
law	ius
justice	ius
right	ius
Quirinus	Quirinus
Remus	Remus
Vesta	Vesta
faith	fides
trust	fides
of_the_hair_and_beard	canus
white	canus
century	saeculum
mortal_race	saeculum
people_born_at_time	saeculum
generation	saeculum
age	saeculum
become_mild	mitesco
become_mellow	mitesco
vow	votum
free_from_care	securus
laden	onustus
loaded	onustus
the_rising_sun	Oriens
the_east	Oriens
plunder	spolium
drop	demitto
send_down	demitto
of_the_month_of_July	Iulius
Julian	Iulius
of_the_gens_Julia	Iulius
star	astrum
limit	termino
put_bounds_to	termino
fame	fama
rumor	fama
the_ocean	oceanus
Caesar	Caesar
origin	origo
come_inbeing	nascor
born	nascor
rule	dominor
lord_or_master	dominor
slavery	servitium
servitude	servitium
Mycenae	Mycenae
distinguished	clarus
clear	clarus
Phthia	Phthia
Assaracus	Assaracus
age	aetas
slip	labor
glide	labor
den	lustrum
bog	lustrum
please	placeo
wearing_the_toga	togatus
master	dominus
council	consilium
plan	consilium
wear_out	fatigo
tire	fatigo
Prevention_clause	quin
Doubting_clause	quin
introduces_Relative_Clause_of_Characteristic	quin
time	tempus
turning_point	meta
boundary	meta
goal	meta
limit	meta
concerning	de
about	de
down_from	de
his/her/its_own	suus
pertaining_Mavors_or_Mars	Mavortius
take	excipio
receive	excipio
Romulus	Romulus
skin	tegmen
means_of_covering	tegmen
nurse	nutrix
reddish_or_tawny_yellow	fulvus
she_wolf	lupa
from_then	inde
from_there	inde
Ilia	Ilia
offspring	partus
birth	partus
priestess	sacerdos
priest	sacerdos
until	donec
Hectorean	Hectoreus
of_Hector	Hectoreus
100th	centum
100	centum
AlbLonga	Alba
Alba	Alba
fortify	munio
build	munio
bring_across	transfero
fulfil	expleo
fill_up	expleo
month	mensis
30th	triginta
30	triginta
Trojan	Ilius
Ilian	Ilius
of_Ilium	Ilius
stand	sto
Ilus	Ilus
give_to	addo
Julus	Iulus
surname	cognomen
Ascanius	Ascanius
slave	puer
boy	puer
drive_under	subigo
winter_quarters	hiberna
Rutulus	Rutulus
go_across	transeo
3_each	terni
summer	aestas
3rd	tertius
custom	mos
beat_crush_bruise_destroy	contundo
wild	ferox
bold	ferox
hidden	arcanus
mysterious	arcanus
secret	arcanus
bite_again_and_again	remordeo
some_day	quando
since	quando
when	quando
noble_spirited	magnanimus
elevated_lofty_heroic_noble	sublimis
Lavinium	Lavinium
promise	promitto
let_loose	promitto
send_forth	promitto
separate	cerno
discern	cerno
your_friends	tui
unrelenting	immotus
unchanged	immotus
unmoved	immotus
the_Cytherean_goddess	Cytherea
Venus	Cytherea
spare	parco
daughter	nata
taste	libo
pour	libo
kiss	osculum
brighten	sereno
make_clear	sereno
planter_sower_begetter_father_founder	sator
smile_upon	subrideo
disjoin	disiungo
betray	prodo
put_forth	prodo
not_uttered	infandus

nod_to	adnuo
us	nos
we	nos
keep_quiet	quiesco
sleep	quiesco
favor	pax
peace	pax
name	nomen
Patavium	Patavium
however	tamen
nevertheless	tamen
cast_forth	prorumpo
cause_burst_forth	prorumpo
go	eo
9th	novem
9	novem
the_Timavus	Timavus
overcome	supero
fountain	fons
spring	fons
of_the_Liburnians	Liburnus
deeper	interior
nearer	interior
penetrate	penetro
tribes_in_Dalmatiand_Albania	Illyrius
of_the_Illyrians	Illyrius
Greek	Achivus
Achaean	Achivus
slip_away	elabor
Antenor	Antenor
chance	fortuna
fortune	fortuna
same	idem
balance	rependo
make_up_for	rependo
opposite	contrarius
console	solor
the_west	occasus
setting	occasus
going_down	occasus
indeed	equidem
opinion	sententia
promise	polliceor
dominion	dicio
Teucer	Teucer
certainly	certo
without_doubt	certo
orb	orbis
circle	orbis
dead_body	funus
death	funus
funeral	funus
entrust	committo
join	committo
terrify	terreo
thunderbolt	fulmen
lightening	fulmen
Venus	Venus
address	alloquor
speak_to	alloquor
shining	nitens
overspread	suffundo
pour_through	suffundo
pour_from_below	suffundo
tear	lacrima
sad	tristis
light	lumen
fix	defigo
sail_covered	velivolus
despise	despicio
look_down_upon	despicio
Cloanthus	Cloanthus
Gyas	Gyas
Lycus	Lycus
cruel	crudelis
unfeeling	crudelis
sigh	gemo
groan	gemo
Amycus	Amycus
piercing	acer
sharp	acer
dutiful	pius
particularly	praecipue
especially	praecipue
hear	exaudio
extreme	extremus
farthest	extremus
believe	credo
trust	credo
live	vivo
or_if	sive
whether	sive
doubtful	dubius
anxiety	metus
dread	metus
fear	metus
seek	requiro
conversation	sermo
lose	amitto
send_away	amitto
move_back	removeo
table	mensa
famine	fames
hunger	fames
remove	eximo
take_away	eximo
of_wild_beasts	ferinus
dull	pinguis
fat	pinguis
Bacchus	Bacchus
fill_in/up	impleo
herb	herba
grass	herba
food	victus
another	alius
other	alius
put	loco
place	loco
vessel	aenum
fasten	figo
fix	figo
tremble	tremo
spit	veru
cut	seco
piece	frustum
portion	pars
part	pars
strip	nudo
bare	nudo
innards	viscus
rib	costa
snatch	diripio
tear_apart_or_off	diripio
future	futurus
about_be	futurus
feast	daps
gird_on	accingo
prey	praeda
booty	praeda
imitate	simulo
expression	vultus
hope	spes
sick	aeger
concern	cura
care	cura
endure	duro
harden	duro
reappear	resurgo
rise_again	resurgo
there	illic
show	ostendo
in_repose	quietus
inactive	quietus
free_from_exertion	quietus
at_rest	quietus
difference	discrimen
crisis	discrimen
division	discrimen
varied	varius
please	iuvo
help	iuvo
recollect	memini
remember	memini
perhaps	forsan
let_go	mitto
release	mitto
send	mitto
fear	timor
depressing	maestus
sad	maestus
call_back	revoco
experience	experior
try	experior
test	experior
pertaining_the_Cyclops	Cyclopius
included	accedo
added	accedo
approach	accedo
sounding	sonans
internally	penitus
madness	rabies
pertaining_Scylla	Scyllaeus
boundary	finis
end	finis
calamity	malum
evil	malum
ignorant	ignarus
neither_…_nor_…	neque
and_not	neque
sorrowful	maereo
separate	divido
divide	divido
hero	heros
demigod	heros
go_away	abeo
Sicilian	Trinacriaus
Acestes	Acestes
burden	onero
load	onero
wine_jar	cadus
jar	cadus
next	deinde
then	deinde
good	bonus
wine	vinum
share	partior
divide	partior
comrade	socius
ally	socius
equalize	aequo
make_level	aequo
ground	humus
scatter	fundo
pour	fundo
victor	victor
conqueror	victor
before	priusquam
stand_off_or_away_from	absisto
uproar	turba
crowd	turba
formed_of_leaves	frondeus
also	et
even	et
spread	sterno
branching	arboreus
pertaining_trees	arboreus
horn	cornu
leader	ductor
arrow	sagitta
swift	celer
band_of_men	manus
hand	manus
arch	arcus
bow	arcus
stand	consisto
halt	consisto

take_position	consisto
nourish	pascor
feed	pascor
valley	valles
the_back_of_men_or_animals	tergum
come_next	sequor
follow	sequor
herd	armentum
stag	cervus
no	nullus
not_any	nullus
Caicus	Caicus
Capys	Capys
boat_with_two_oars	biremis
Trojan	Phrygius
territory_in_Asiminor	Phrygius
Phrygian	Phrygius
Antheus	Antheus
looking_forth	prospectus
ascend	conscendo
prepare	paro
boil	torreo
burn	torreo
take_back	recipio
fruit	frux
thing	res
affair	res
business	res
matter	res
_useful	expedio
set_free	expedio
pertaining_Ceres	Cerealis
ruin	corrumpo
destroy	corrumpo
Ceres	Ceres
wheat	Ceres
fuel	fomes
kindling_stuff	fomes
fuel	nutrimentum
nourishment	nutrimentum
dry	aridus
leaf	folium
take_up	suscipio
strike_out	excudo
spark	scintilla
flint	silex
first	primum
place	pono
leg	artus
limb	artus
drip	tabeo
melt	tabeo
obtain	potior
desired	optatus
love	amor
go_under	subeo
amount	numerus
number	numerus
hither	huc
here	huc
bite	morsus
an_anchor	ancora
hold_fast	adligo
tie_or_bind_to	adligo
crooked	uncus
hooked	uncus
any	ullus
tired	fessus
bench	sedile
alive	vivus
sweet	dulcis
inside	intus
within	intus
forehead	frons
shadow	umbra
overhang	immineo
threaten	immineo
forest	nemus
grove	nemus
from_above	desuper
gleaming	coruscus
vibrating	coruscus
scene	scaena
piece_of_theatrical_behavior	scaena
stage	scaena
safe	tutus
threaten	minor
twin	geminus
rock	rupes
drawn_back	reductus
tear_asunder	scindo
rend	scindo
cut	scindo
chest	sinus
pocket	sinus
fold	sinus
projection	obiectus
throwing_against	obiectus
accomplish	efficio
carry_out	efficio
port	portus
apartment_block	insula
island	insula
retreat	secessus
going_apart	secessus
go_towards	peto
seek	peto
exert	contendo
strain	contendo
advance	cursus
course	cursus
near	prope
son_of_Aeneas	Aeneades
exhausted	defessus
weary	defessus
second	secundus
following	secundus
strap	lorum
thong	lorum
horse	equus
bend	flecto

carry_inor_forward	inveho
father	genitor
after	postquam
breaking	fragor
fall	cado
all	cunctus
rule	rego
stand_near	asto
ear	auris
bristle_up	arrigo
erect	arrigo
raise_up	arrigo
silent	sileo
behold	conspicio
catch_sight_of	conspicio
by_chance	forte
heavy	gravis
serve	ministro
attend	ministro
madness	furor
fly	volo
torch	fax
common_people	vulgus
unknown	ignobilis
rage	saevio
revolt	seditio
arise	coorior
often	saepe
glide_through_or_over	perlabor
trivial	levis
light	levis
wheel	rota
make_light	levo
raise	levo
push_off_from	detrudo
thrust_down_or_away	detrudo

press_upon	adnitor
Triton	Triton
at_the_same_time	simul
Cymothoe	Cymothoe
bring_back	reduco
sun	sol
put_flight	fugo
collect	colligo
soothe	placo
swollen	tumidus
quickly	cito
saying	dictum
word	dictum
say_yes	aio
affirm	aio
say	aio
rule	regno
close	claudo
palace	aula
forecourt	aula
home	domus
house	domus
fate	sors
trident	tridens
three_pronged	tridens
sea	pelagus
escape	fuga
flight	fuga
hasten	maturo
pay_for	luo
satisfy	luo
an_offense	commissum
punishment	poena
similar	similis
after	post
calm_down	compono
bury	compono
arrange	compono
build	compono
outstanding	praesto
move	moveo
dare	audeo
without	sine
mine	meus
my	meus
your	vester
trust	fiducia
you	vos
say	for
speak	for
then_next	dehinc
or_west_wind	Zephyrus
Zephyr	Zephyrus
brother	frater
trick	dolus
device	dolus
artifice	dolus
collapse	ruina
press_on	opprimo

lift_up	extollo
pleasant	placidus
inspect	prospicio
see_in_front	prospicio
move_away	commoveo
shake	commoveo
heavily	graviter
cast	refundo
pour_back_or_up	refundo
standing_water	stagnum
Neptunus	Neptunus
perceive	sentio
send_out	emitto
mingle	misceo
mix	misceo
meanwhile	interea
open	fatisco
come_apart	fatisco
crack	rima
cleft	rima
rain	imber
receive	accipio
fastening	compages
joining	compages
winter	hiems
Aletes	Aletes
very_aged	grandaevus
Abas	Abas
Achates	Achates
ship	navis
Ilioneus	Ilioneus
strong	validus
royal_treasury	gaza
treasure	gaza
Trojan	Troius
of_Troy	Troius
writing_tablet	tabula
painting	tabula
_board	tabula
plank	tabula
whirlpool	gurges
swim	no
thin	rarus
loose	rarus
become_visible	appareo
appear	appareo
swallow_up	voro
in_the_same_place	ibidem
head	caput
teacher	magister
chief	magister
master	magister
easy	pronus
sloping	pronus
shake_off	excutio
summit	vertex
peak	vertex
whirlpool	vertex
Orontes	Orontes
carry	veho
trustworthy	fidus
faithful	fidus
Lycian	Lycius
surround	cingo
rampart	agger
mound	agger
shallow	vadum
ford	vadum
dash_upon	inlido
see	video
deserving_pitied	miserabilis
deplorable	miserabilis
press	urgeo

sand_bank_or_shoal_in_the_sea	syrtis
brief	brevis
short	brevis
monstrous	immanis
huge	immanis
the_back	dorsum
Aras	Ara
in_half	medius
in_the_middle	medius
middle	medius
Italian	Italus
call	voco
twist	torqueo
hidden	lateo
lie_hidden	lateo
stone	saxum
boulder	saxum
rock	saxum
take_away_violently	abripio
3	tres
arena	arena
sand	arena
tide	aestus
wave	aestus
heat	aestus
open	aperio
during	inter
among	inter
between	inter
gape	dehisco
hang	pendeo
above	superus
water	aqua

burst_or_break_off_in_front	praerumpo
flood	cumulus
heap	cumulus
the_prow	prora
the_extreme_forward_part_of_ship	prora
oar	remus
shatter	frango
break	frango
hit	ferio
towards	adversus
opposite	adversus
opposed	adversus
Aquilo	Aquilo
creak	strideo
produce_grating_or_shrill_sound	strideo
helmet	galea
shield	scutum
wave	unda
Simois	Simois
Sarpedon	Sarpedon
huge	ingens
Hector	Hector
lie	iaceo
missile_weapon	telum
spear	telum
son_or_descendant_of_Aeacus	Aeacides
right_hand	dextera
pour_out	effundo
spirit	anima
breath	anima
not	non
plain	campus
sink	occumbo
Trojan	Iliacus
Ilian	Iliacus
belonging_Ilium	Iliacus
the_son_of_Tydeus	Tydides
Diomedes	Tydides
strong	fortis
brave	fortis
perish	oppeto
encounter	oppeto
touch	contingo
face	os
mouth	os
in_front_of	ante
before	ante
blessed	beatus
happy	beatus
4_times	quater
3_times	ter
bring_back	refero
palm	palma
hand	palma
star	sidus
double	duplex
sigh_or_groan	ingemo
limb	membrum
cold	frigus
pay	solvo
release	solvo
Aeneas	Aeneas
immediately	extemplo
death	mors
stretch	intento
present	praesens
upper_air	aether
vibrate	mico
move_quickly_and_fro	mico
heavens	polus
pole	polus
thunder_forth	intono
lie	incubo
night	nox
eye	oculus
day	dies
suddenly	subito
snatch_away	eripio
tear_away	eripio

cord	rudens
rope	rudens
harsh	stridor
shout	clamor
outcry	clamor
pursue	insequor
follow_after	insequor
African	Africus
gale	procella
close	creber
crowded	creber
thick	creber
the_south_wind	Notus
Southwest_wind	Eurus
together	una

vile	inferus
low	inferus
seat	sedes
bear_down_on	incumbo
lean_or_recline_upon	incumbo
sweep_over	perflo
blew_through_or_over	perflo
gate	porta
anywhere	qua
anyhow	qua
how	qua
where	qua
line_of_march	agmen
just_as	velut
strength	latus
flank	latus
side	latus
spear	cuspis
sharp_point	cuspis
turn_back	converto
cause_turn	converto
turn_round	converto
hollow	cavus
speak	dico
say	dico
when	ubi
where	ubi
powerful	potens
lie_down	accumbo
feast	epulae
banquet	epulae
reconcile	concilio
advise	concilio
whoever	quicumque
right	fas
seize	capesso
order	iussum
command	iussum
investigate	exploro
explore	exploro
choose	opto
desire	opto
O	o
your	tuus
parent	parens
descendants	proles
complete	exigo
achieve	exigo
collect	exigo
drive_out	exigo
reward	meritum
punishment	meritum
devote	dico
one's_own	proprius
permanent	stabilis
steadfast	stabilis
join	iungo
marriage	conubium
Deiopea	Deiopea
beautiful	pulcher
nymph	nympha
bride	nympha
outstanding	praestans
7th	septem
7	septem
twice	bis
body	corpus
diverse	diversus
different	diversus
stern_of_ship	puppis
cover	obruo
add	incutio
strike_inor_upon	incutio
household_gods	Penates
Penates	Penates
carry_load	porto
Troy	Ilium
Ilium	Ilium
navigate	navigo
sail	navigo
Tuscan	Tyrrhenus
Etruscan	Tyrrhenus
Tyrrhenian	Tyrrhenus
hostile	inimicus
unfriendly	inimicus
destroy	tollo
raise	tollo
flood	fluctus
lick	mulceo
stroke	mulceo
man	homo
human_being	homo
you	tu
for_in_fact	namque
use	utor
voice	vox
rein	habena
order	iubeo
know	scio
_unstrung	laxus
not_drawn_tight	laxus
spacious	laxus
loose	laxus
wide	laxus
fixed	certus
sure	certus
treaty	foedus
contract	foedus
overhead	insuper
above	insuper
black	ater
conceal	abdo
withdraw	abdo
cave	spelunca
all_powerful	omnipotens
breeze	aura
sweep	verro
deep	profundus
heaven	caelum
sky	caelum
make	facio
do	facio
unless	nisi

moderate	tempero
soothe	mollio
soften	mollio
scepter	sceptrum
royal_staff	sceptrum
sit	sedeo
lofty	celsus
high	celsus
roar	fremo
bar	claustrum
bolt	claustrum
mountain	mons
murmur	murmur
roar	murmur
rumble	murmur
great	magnus
fret	indignor
deem_unworthy	indignor
bridle	freno
jail	carcer
bond	vinculum
and_in_addition	ac
press	premo
power	imperium
command	imperium
loud_sounding	sonorus
storm	tempestas
season	tempestas
strive	luctor
struggle	luctor
wrestle	luctor
cave	antrum
Aeolus	Aeolus
vast	vastus
empty	vastus
Aeolia	Aeolia
the_southerly_or_south_wind	Auster
mad	furo
rage	furo
pregnant	fetus
region	locus
place	locus
country	patria
downpour	nimbus
cloud_burst	nimbus
rain_cloud	nimbus
roll_back	voluto
roll_about	voluto
heart	cor
set_on_fire	flammo
such	talis
impose	impono
put_on	impono
altar	ara
suppliant	supplex

or	aut
besides	praeterea
venerate	adoro
pray_to	adoro
anyone	quisquam
someone	quisquam
spouse	coniunx
sister	soror
walk	incedo
proceed	incedo
happen	incedo
go	incedo
god	divus
piercing	acutus
sharp	acutus
fasten_in_or_upon	infigo
high_cliff_or_rock	scopulus
projecting_ledge_of_rock	scopulus
rebuke	corripio
plunder	corripio
seize	corripio
whirlwind	turbo
flame	flamma
transfix	transfigo
breathe_out	exspiro
wind	ventus
overthrow	everto
overturn	everto
raft	ratis
throw	disicio
fire	ignis
cloud	nubes
throw	iaculor
dart	iaculor
hurl_the_javelin	iaculor
swift	rapidus
Jupiter	Iuppiter
Oileus	Oileus
Ajax	Aiax
rage	furiae
injury	noxa
harm	noxa
the_open_sea	pontus
submerge	summergo
plunge_beneath	summergo
itself	ipse
herself	ipse
himself	ipse
fleet	classis
division	classis
burn_out	exuro
Pallas	Pallas
forbid	veto
indeed	quippe
turn_away	averto
Trojan	Teucrus
of_Teucer	Teucrus
able	possum
and_not	nec
nor	nec
conquer	vinco
desist	desisto
cease	desisto
deliberation	inceptum
beginning	inceptum
with	cum
itself	sui
herself	sui
himself	sui
wound	vulnus
heart	pectus
breast	pectus
chest	pectus
under	sub
save	servo
eternal	aeternus
everlasting	aeternus
although	cum
since	cum
when	cum
rush	ruo
money	aes
bronze	aes
copper	aes
wit	sal
salt	sal
froth	spuma
happy	laetus
give	do
awning	velum
sail	velum
on	in
in	in
earth	tellus
Sicilian	Siculus
pertaining_the_Sicani	Siculus
view	conspectus
sight	conspectus
look	conspectus
from	e
out_of	e
scarcely	vix
Roman	Romanus
rock	moles
large/shapeless_mass	moles
around	circum
sea	mare
concern_oneself_with	ago
act	ago
do	ago
drive	ago
err	erro
wander	erro
year	annus
through	per
shut_up	arceo
shut_in	arceo
Achilles	Achilles
cruel	immitis
harsh	immitis
hard	immitis
Greeks	Danai
Danai	Danai
remains	reliquiae
Trojans	Troes
whole	totus
plain	aequor
sea	aequor
level_surface	aequor
over	super
set_on_fire	accendo
kindle	accendo
office	honor
honor	honor
Ganymede	Ganymedes
carry_off	rapio
seize	rapio
hostile	invisus
hated	invisus
beauty	forma
shape	forma
wrong	iniuria
injustice	iniuria
reject	sperno
Paris	Paris
trial	iudicium
decision	iudicium
put_back	repono
mind	mens
remain	maneo
forgotten	excido
perish	excido
drop	excido
fall_out	excido
grief	dolor
pain	dolor
also	etiam
nor_yet	necdum
Greek	Argus
Argive	Argus
manage	gero
bear	gero
precious	carus
in_accordance_with	pro
instead_of	pro
for	pro
on_behalf_of	pro
towards	ad
up_to	ad
to	ad
Saturnian	Saturnius
beloning_Saturn	Saturnius
old	vetus
dread	metuo
fear	metuo
that	is
she_it	is
he	is
one_of_the_Fates	Parca
Parca	Parca
in_this_way	sic
so	sic
Libya	Libya
razing	excidium
complete_cutting_or_tearing_down	excidium
arrogant	superbus
king	rex
wide	latus
broad	latus
people	populus
hence	hinc
from_here	hinc
citadel	arx
summit	arx
turn	verto
formerly	olim
hear	audio
consider	duco
lead	duco
blood	sanguis
Trojan	Troianus
for	enim
in_fact	enim
but	sed
descent	progenies
favor	foveo
warm	foveo
stretch	tendo
at_that_time	tum
then	tum
already	iam
now	iam
allow	sino
someone/thing	quis
anyone/thing	quis
if	si
clan	gens
family	gens
goddess	dea
kingdom	regnum
royal_power	regnum
these	hic
this	hic
chariot	currus
here	hic
Samos	Samos
cultivate	colo
inhabit	colo
overlook	posthabeo
esteem_less	posthabeo
hold_next	posthabeo
1	unus
all	omnis
every	omnis
more	magis
report	fero
carry	fero
bear	fero
rough	asper
eagerness	studium
resources	ops
as_substantive_rich_man	dives
rich	dives
door	ostium
far	longus
long	longus
pertaining_the_Tiber	Tiberinus
opposite	contra
against	contra
Carthage	Carthago
hold	teneo
Tyrian_or_Phoenician	Tyrius
of_Tyre	Tyrius
be	sum
old	antiquus
ancient	antiquus
from_heaven	caelestis
mind	animus
spirit	animus

so_great	tantus
so_much	tantus
strike_against	impello
work	labor
go_to	adeo
devotion	pietas
distinguished	insignis
chance	casus
fall	casus
ponder	volvo
roll	volvo
so_many	tot
queen	regina
feel_pain/grief	doleo
or	ve
hurt	laedo
injure_by_striking	laedo
divine_will	numen
what	quis
who	quis
remember	memoro
lawsuit	causa
reason	causa
cause	causa
Muse	Musa
Rome	Roma
walls	moenia
deep	altus
high	altus
tall	altus
also	atque
and	atque
Senators	pater
_Patricians	pater
father	pater
birthplace_of_Romulus_and_Remus)	Albanus
pertaining_AlbLong(city_in_Latium	Albanus
Latin	Latinus
of_Latium	Latinus
whence	unde
from_where	unde
origin	genus
Latium	Latium
god	deus
bring_upon/against	infero
city	urbs
place	condo
store_up	condo
build	condo
provided_that	dum
until	dum
while	dum
endure	patior
permit	patior
war	bellum
also	quoque
many	multus
much	multus
anger	ira
on_account_of	ob
Juno	Iuno
remembering	memor
savage	saevus

those_above	superi
force	vis
height	altum
deep_sea	altum
throw	iacto
land	terra
lot	multum
much	multum
sea_shore	litus
come	venio
Lavinius	Lavinius
exiled	profugus
fugitive	profugus
fate	fatum
destiny	fatum
Italy	Italia
coast	ora
shore	ora
by	a
from	a
first	primus
Troy	Troia
sing	cano
and	que
man	vir
weapons	arma
arms	arma
Mars	Mars
bristling	horrens
now	nunc
but	at
farmer	agricola
need	opus
work	opus
grateful	gratus
pleasant	gratus
colonist	colonus
farmer	colonus
field	arvum
present	pareo
appear	pareo
obey	pareo
keen	avidus
greedy	avidus
although	quamvis
even_though	quamvis
how_In_what_manner	ut
that	ut
when	ut
as	ut
so_that	ut
compel	cogo
drive_together	cogo
neighboring	vicinus
forest	silva
depart	egredior
and	et
poem	carmen
song	carmen
straw	avena
regulate	modulor
measure	modulor
thin	gracilis
sometimes	quondam
at_times	quondam
formerly	quondam
which	qui
who	qui
me	ego
I	ego
that	ille
